,Player2,Player1,Unnamed: 0,Round,Result,FSP.1,FSW.1,SSP.1,SSW.1,FSP.2,FSW.2,SSP.2,SSW.2,Unary_SSP.1,Unary_SSW.1,Unary_SSP.2,FSP_diff,FSW_diff,SSW_diff,FSP_ratio,Total_serve_percentage_1,Total_won_serves_1,Total_serve_percentage_2,GROUPBY_['Round']_mean_FSP_diff,"GROUPBY_['Player1', 'Player2']_mean_FSP_diff","GROUPBY_['Player1', 'Player2']_mean_SSW_diff",GROUPBY_['Round']_mean_Total_won_serves_1,"GROUPBY_['Player1', 'Player2']_max_Round","GROUPBY_['Player1', 'Player2']_max_FSP.1","GROUPBY_['Player1', 'Player2']_count_Round","GROUPBY_['Player1', 'Round']_mean_SSP.1","GROUPBY_['Player1', 'Player2']_mean_Result","GROUPBY_['Player1', 'Player2', 'Round']_mean_SSP.1","GROUPBY_['Player1', 'Player2', 'Round']_mean_FSP_ratio",Player1_has_high_FSW
0,Novak Djokovic,Lukas Lacko,0,1,0,61,35,39,18,68,45,32,17,0.5208333333333334,0.34615384615384615,0.26881720430107525,-7,-10,1,0.8970588235294118,2.5641025641025643,53,100,0.5652985074626866,-7.0,1.0,57.115671641791046,1,61,1,45.666666666666664,0.0,39.0,0.8970588235294118,0
1,Albert Montanes,Leonardo Mayer,1,1,1,61,31,39,13,60,23,40,9,0.5208333333333334,0.25,0.3548387096774194,1,8,4,1.0166666666666666,2.5641025641025643,44,100,0.5652985074626866,1.0,4.0,57.115671641791046,1,61,1,39.0,1.0,39.0,1.0166666666666666,1
2,Denis Istomin,Marcos Baghdatis,2,1,0,52,53,48,20,77,57,23,15,0.7083333333333334,0.38461538461538464,0.17204301075268819,-25,-4,5,0.6753246753246753,2.0833333333333335,73,100,0.5652985074626866,-25.0,5.0,57.115671641791046,1,52,1,48.333333333333336,0.0,48.0,0.6753246753246753,0
3,Michael Russell,Dmitry Tursunov,3,1,1,53,39,47,24,50,24,50,19,0.6875,0.46153846153846156,0.46236559139784944,3,15,5,1.06,2.127659574468085,63,100,0.5652985074626866,3.0,5.0,57.115671641791046,1,53,1,47.0,1.0,47.0,1.06,1
4,Ernests Gulbis,Juan Monaco,4,1,0,76,63,24,12,53,59,47,32,0.20833333333333334,0.23076923076923078,0.43010752688172044,23,4,-20,1.4339622641509433,4.166666666666667,75,100,0.5652985074626866,23.0,-20.0,57.115671641791046,1,76,1,23.0,0.0,24.0,1.4339622641509433,1
5,Sam Querrey,Santiago Giraldo,5,1,0,65,51,35,22,63,60,37,22,0.4375,0.4230769230769231,0.3225806451612903,2,-9,0,1.0317460317460319,2.857142857142857,73,100,0.5652985074626866,2.0,0.0,57.115671641791046,1,65,1,38.5,0.0,35.0,1.0317460317460319,0
6,Jarkko Nieminen,Dudi Sela,6,1,0,68,73,32,24,60,66,40,34,0.375,0.46153846153846156,0.3548387096774194,8,7,-10,1.1333333333333333,3.125,97,100,0.5652985074626866,8.0,-10.0,57.115671641791046,1,68,1,35.0,0.0,32.0,1.1333333333333333,1
7,Alex Bogomolov Jr.,Fabio Fognini,7,1,1,47,18,53,15,54,26,46,13,0.8125,0.28846153846153844,0.41935483870967744,-7,-8,2,0.8703703703703703,1.8867924528301887,33,100,0.5652985074626866,-7.0,2.0,57.115671641791046,1,47,1,53.0,1.0,53.0,0.8703703703703703,0
8,Richard Gasquet,David Guez,8,1,0,64,26,36,12,67,42,33,14,0.4583333333333333,0.23076923076923078,0.27956989247311825,-3,-16,-2,0.9552238805970149,2.7777777777777777,38,100,0.5652985074626866,-3.0,-2.0,57.115671641791046,1,64,1,36.0,0.0,36.0,0.9552238805970149,0
9,Lukasz Kubot,Nikolay Davydenko,9,1,1,77,76,23,11,60,68,40,25,0.1875,0.21153846153846154,0.3548387096774194,17,8,-14,1.2833333333333334,4.3478260869565215,87,100,0.5652985074626866,17.0,-14.0,57.115671641791046,1,77,1,23.0,1.0,23.0,1.2833333333333334,1
10,Julien Benneteau,Pablo Carreno Busta,10,1,0,53,46,47,35,66,62,34,24,0.6875,0.6730769230769231,0.2903225806451613,-13,-16,11,0.803030303030303,2.127659574468085,81,100,0.5652985074626866,-13.0,11.0,57.115671641791046,1,53,1,47.0,0.0,47.0,0.803030303030303,0
11,Lukas Rosol,Tommy Robredo,11,1,1,57,62,43,43,51,72,49,41,0.6041666666666666,0.8269230769230769,0.45161290322580644,6,-10,2,1.1176470588235294,2.3255813953488373,105,100,0.5652985074626866,6.0,2.0,57.115671641791046,1,57,1,42.6,1.0,43.0,1.1176470588235294,0
12,Vasek Pospisil,Samuel Groth,12,1,0,65,40,35,17,67,45,33,13,0.4375,0.3269230769230769,0.27956989247311825,-2,-5,4,0.9701492537313433,2.857142857142857,57,100,0.5652985074626866,-2.0,4.0,57.115671641791046,1,65,1,35.0,0.0,35.0,0.9701492537313433,0
13,Matthew Ebden,Nicolas Mahut,13,1,0,64,63,36,23,67,58,33,23,0.4583333333333333,0.4423076923076923,0.27956989247311825,-3,5,0,0.9552238805970149,2.7777777777777777,86,100,0.5652985074626866,-3.0,0.0,57.115671641791046,1,64,1,36.5,0.0,36.0,0.9552238805970149,1
14,Mikhail Kukushkin,Alejandro Falla,14,1,1,60,50,40,23,55,55,45,23,0.5416666666666666,0.4423076923076923,0.40860215053763443,5,-5,0,1.0909090909090908,2.5,73,100,0.5652985074626866,5.0,0.0,57.115671641791046,1,60,1,43.0,1.0,40.0,1.0909090909090908,0
15,Andrey Golubev,Stanislas Wawrinka,15,1,1,63,20,37,6,64,18,36,10,0.4791666666666667,0.11538461538461539,0.3118279569892473,-1,2,-4,0.984375,2.7027027027027026,26,100,0.5652985074626866,-1.0,-4.0,57.115671641791046,1,63,1,41.166666666666664,1.0,37.0,0.984375,1
16,David Ferrer,Alejandro Gonzalez,16,1,0,68,34,32,7,53,28,47,21,0.375,0.1346153846153846,0.43010752688172044,15,6,-14,1.2830188679245282,3.125,41,100,0.5652985074626866,15.0,-14.0,57.115671641791046,1,68,1,32.0,0.0,32.0,1.2830188679245282,1
17,Adrian Mannarino,Steve Johnson,17,1,0,53,50,47,28,58,52,42,37,0.6875,0.5384615384615384,0.3763440860215054,-5,-2,-9,0.9137931034482759,2.127659574468085,78,100,0.5652985074626866,-5.0,-9.0,57.115671641791046,1,53,1,46.0,0.0,47.0,0.9137931034482759,0
18,Alexandr Dolgopolov,Ricardas Berankis,18,1,0,50,39,50,26,58,42,42,23,0.75,0.5,0.3763440860215054,-8,-3,3,0.8620689655172413,2.0,65,100,0.5652985074626866,-8.0,3.0,57.115671641791046,1,50,1,50.0,0.0,50.0,0.8620689655172413,0
19,Jesse Huta Galung,Jeremy Chardy,19,1,1,66,46,34,16,57,41,43,13,0.4166666666666667,0.3076923076923077,0.3870967741935484,9,5,3,1.1578947368421053,2.9411764705882355,62,100,0.5652985074626866,9.0,3.0,57.115671641791046,1,66,1,34.0,1.0,34.0,1.1578947368421053,1
20,Jerzy Janowicz,Jordan Thompson,20,1,0,60,58,40,21,64,74,36,27,0.5416666666666666,0.40384615384615385,0.3118279569892473,-4,-16,-6,0.9375,2.5,79,100,0.5652985074626866,-4.0,-6.0,57.115671641791046,1,60,1,40.0,0.0,40.0,0.9375,0
21,Pablo Andujar,Albert Ramos,21,1,0,61,32,39,10,73,40,27,15,0.5208333333333334,0.19230769230769232,0.21505376344086022,-12,-8,-5,0.8356164383561644,2.5641025641025643,42,100,0.5652985074626866,-12.0,-5.0,57.115671641791046,1,61,1,41.0,0.0,39.0,0.8356164383561644,0
22,Denis Kudla,Florian Mayer,22,1,1,58,36,42,22,59,35,41,18,0.5833333333333334,0.4230769230769231,0.3655913978494624,-1,1,4,0.9830508474576272,2.380952380952381,58,100,0.5652985074626866,-1.0,4.0,57.115671641791046,1,58,1,39.333333333333336,1.0,42.0,0.9830508474576272,1
23,Jan-Lennard Struff,Mikhail Youzhny,23,1,1,69,39,31,17,49,24,51,12,0.3541666666666667,0.3269230769230769,0.4731182795698925,20,15,5,1.4081632653061225,3.225806451612903,56,100,0.5652985074626866,20.0,5.0,57.115671641791046,1,69,1,35.666666666666664,1.0,31.0,1.4081632653061225,1
24,Tommy Haas,Guillermo Garcia-Lopez,24,1,1,58,27,42,11,52,22,48,11,0.5833333333333334,0.21153846153846154,0.44086021505376344,6,5,0,1.1153846153846154,2.380952380952381,38,100,0.5652985074626866,6.0,0.0,57.115671641791046,1,58,1,47.0,1.0,42.0,1.1153846153846154,1
25,Edouard Roger-Vasselin,Carlos Berlocq,25,1,0,57,49,43,32,65,67,35,32,0.6041666666666666,0.6153846153846154,0.3010752688172043,-8,-18,0,0.8769230769230769,2.3255813953488373,81,100,0.5652985074626866,-8.0,0.0,57.115671641791046,1,57,1,35.0,0.0,43.0,0.8769230769230769,0
26,Joao Sousa,Dominic Thiem,26,1,1,55,60,45,31,65,57,35,30,0.6458333333333334,0.5961538461538461,0.3010752688172043,-10,3,1,0.8461538461538461,2.2222222222222223,91,100,0.5652985074626866,-10.0,1.0,57.115671641791046,1,55,1,45.0,1.0,45.0,0.8461538461538461,1
27,Jiri Vesely,Kevin Anderson,27,1,1,63,76,37,28,57,69,43,43,0.4791666666666667,0.5384615384615384,0.3870967741935484,6,7,-15,1.105263157894737,2.7027027027027026,104,100,0.5652985074626866,6.0,-15.0,57.115671641791046,1,63,1,37.0,1.0,37.0,1.105263157894737,1
28,Ivan Dodig,Ivo Karlovic,28,1,0,66,55,34,18,83,68,17,12,0.4166666666666667,0.34615384615384615,0.10752688172043011,-17,-13,6,0.7951807228915663,2.9411764705882355,73,100,0.5652985074626866,-17.0,6.0,57.115671641791046,1,66,1,34.0,0.0,34.0,0.7951807228915663,0
29,Damir Dzumhur,Jan Hajek,29,1,0,73,31,27,6,53,31,47,19,0.2708333333333333,0.11538461538461539,0.43010752688172044,20,0,-13,1.3773584905660377,3.7037037037037037,37,100,0.5652985074626866,20.0,-13.0,57.115671641791046,1,73,1,28.5,0.0,27.0,1.3773584905660377,0
30,Kenny De Schepper,Di Wu,30,1,0,60,46,40,29,62,63,38,20,0.5416666666666666,0.5576923076923077,0.3333333333333333,-2,-17,9,0.967741935483871,2.5,75,100,0.5652985074626866,-2.0,9.0,57.115671641791046,1,60,1,40.0,0.0,40.0,0.967741935483871,0
31,Aleksandr Nedovyesov,Tomas Berdych,31,1,1,66,39,34,19,61,37,39,17,0.4166666666666667,0.36538461538461536,0.34408602150537637,5,2,2,1.0819672131147542,2.9411764705882355,58,100,0.5652985074626866,5.0,2.0,57.115671641791046,1,66,1,34.0,1.0,34.0,1.0819672131147542,1
32,Roger Federer,James Duckworth,32,1,0,52,36,48,19,58,40,42,19,0.7083333333333334,0.36538461538461536,0.3763440860215054,-6,-4,0,0.896551724137931,2.0833333333333335,55,100,0.5652985074626866,-6.0,0.0,57.115671641791046,1,52,1,48.0,0.0,48.0,0.896551724137931,0
33,Blaz Kavcic,Radek Stepanek,33,1,0,51,37,49,29,63,43,37,22,0.7291666666666666,0.5576923076923077,0.3225806451612903,-12,-6,7,0.8095238095238095,2.0408163265306123,66,100,0.5652985074626866,-12.0,7.0,57.115671641791046,1,51,1,43.0,0.0,49.0,0.8095238095238095,0
34,Sergiy Stakhovsky,Teymuraz Gabashvili,34,1,1,58,49,42,24,55,50,45,21,0.5833333333333334,0.46153846153846156,0.40860215053763443,3,-1,3,1.0545454545454545,2.380952380952381,73,100,0.5652985074626866,3.0,3.0,57.115671641791046,1,58,1,42.0,1.0,42.0,1.0545454545454545,0
35,Ze Zhang,Fernando Verdasco,35,1,1,61,59,39,24,58,44,42,25,0.5208333333333334,0.46153846153846156,0.3763440860215054,3,15,-1,1.0517241379310345,2.5641025641025643,83,100,0.5652985074626866,3.0,-1.0,57.115671641791046,1,61,1,38.666666666666664,1.0,39.0,1.0517241379310345,1
36,Gilles Simon,Daniel Brands,36,1,0,63,109,37,36,56,114,44,57,0.4791666666666667,0.6923076923076923,0.3978494623655914,7,-5,-21,1.125,2.7027027027027026,145,100,0.5652985074626866,7.0,-21.0,57.115671641791046,1,63,1,39.0,0.0,37.0,1.125,0
37,Marcel Granollers,Marin Cilic,37,1,1,58,57,42,30,61,64,39,27,0.5833333333333334,0.5769230769230769,0.34408602150537637,-3,-7,3,0.9508196721311475,2.380952380952381,87,100,0.5652985074626866,-3.0,3.0,57.115671641791046,1,58,1,42.0,1.0,42.0,0.9508196721311475,0
38,Julian Reister,Thomaz Bellucci,38,1,1,53,39,47,24,60,41,40,16,0.6875,0.46153846153846156,0.3548387096774194,-7,-2,8,0.8833333333333333,2.127659574468085,63,100,0.5652985074626866,-7.0,8.0,57.115671641791046,1,53,1,47.0,1.0,47.0,0.8833333333333333,0
39,Filippo Volandri,Jo-Wilfried Tsonga,39,1,1,62,37,38,23,57,35,43,20,0.5,0.4423076923076923,0.3870967741935484,5,2,3,1.087719298245614,2.6315789473684212,60,100,0.5652985074626866,5.0,3.0,57.115671641791046,1,62,1,44.0,1.0,38.0,1.087719298245614,1
40,John Isner,Martin Klizan,40,1,1,54,25,46,21,78,36,22,6,0.6666666666666666,0.40384615384615385,0.16129032258064516,-24,-11,15,0.6923076923076923,2.1739130434782608,46,100,0.5652985074626866,-24.0,15.0,57.115671641791046,1,54,1,48.5,1.0,46.0,0.6923076923076923,0
41,Federico Delbonis,Blaz Rola,41,1,1,68,57,32,13,63,38,37,16,0.375,0.25,0.3225806451612903,5,19,-3,1.0793650793650793,3.125,70,100,0.5652985074626866,5.0,-3.0,57.115671641791046,1,68,1,32.0,1.0,32.0,1.0793650793650793,1
42,Horacio Zeballos,Michal Przysiezny,42,1,1,69,48,31,17,60,43,40,18,0.3541666666666667,0.3269230769230769,0.3548387096774194,9,5,-1,1.15,3.225806451612903,65,100,0.5652985074626866,9.0,-1.0,57.115671641791046,1,69,1,32.0,1.0,31.0,1.15,1
43,Aljaz Bedene,Stephane Robert,43,1,1,46,25,54,21,54,40,46,9,0.8333333333333334,0.40384615384615385,0.41935483870967744,-8,-15,12,0.8518518518518519,1.8518518518518519,46,100,0.5652985074626866,-8.0,12.0,57.115671641791046,1,46,1,46.5,1.0,54.0,0.8518518518518519,0
44,Feliciano Lopez,Somdev Devvarman,44,1,0,52,34,48,28,65,50,35,18,0.7083333333333334,0.5384615384615384,0.3010752688172043,-13,-16,10,0.8,2.0833333333333335,62,100,0.5652985074626866,-13.0,10.0,57.115671641791046,1,52,1,43.0,0.0,48.0,0.8,0
45,Michael Llodra,Michael Berrer,45,1,1,63,39,37,19,72,47,28,12,0.4791666666666667,0.36538461538461536,0.22580645161290322,-9,-8,7,0.875,2.7027027027027026,58,100,0.5652985074626866,-9.0,7.0,57.115671641791046,1,63,1,37.0,1.0,37.0,0.875,0
46,Wayne Odesnik,Vincent Millot,46,1,1,57,63,43,34,67,67,33,22,0.6041666666666666,0.6538461538461539,0.27956989247311825,-10,-4,12,0.8507462686567164,2.3255813953488373,97,100,0.5652985074626866,-10.0,12.0,57.115671641791046,1,57,1,43.0,1.0,43.0,0.8507462686567164,0
47,Go Soeda,Andy Murray,47,1,1,69,33,31,11,61,28,39,6,0.3541666666666667,0.21153846153846154,0.34408602150537637,8,5,5,1.1311475409836065,3.225806451612903,44,100,0.5652985074626866,8.0,5.0,57.115671641791046,1,69,1,38.333333333333336,1.0,31.0,1.1311475409836065,1
48,Juan Martin Del Potro,Rhyne Williams,48,1,0,57,52,43,25,64,62,36,23,0.6041666666666666,0.4807692307692308,0.3118279569892473,-7,-10,2,0.890625,2.3255813953488373,77,100,0.5652985074626866,-7.0,2.0,57.115671641791046,1,57,1,44.0,0.0,43.0,0.890625,0
49,Tim Smyczek,Roberto Bautista Agut,49,1,1,82,37,18,7,61,28,39,10,0.08333333333333333,0.1346153846153846,0.34408602150537637,21,9,-3,1.3442622950819672,5.555555555555555,44,100,0.5652985074626866,21.0,-3.0,57.115671641791046,1,82,1,24.5,1.0,18.0,1.3442622950819672,1
50,Benjamin Becker,Nick Kyrgios,50,1,1,54,60,46,25,53,45,47,31,0.6666666666666666,0.4807692307692308,0.43010752688172044,1,15,-6,1.0188679245283019,2.1739130434782608,85,100,0.5652985074626866,1.0,-6.0,57.115671641791046,1,54,1,38.5,1.0,46.0,1.0188679245283019,1
51,Frank Dancevic,Benoit Paire,51,1,1,57,54,43,22,59,47,41,20,0.6041666666666666,0.4230769230769231,0.3655913978494624,-2,7,2,0.9661016949152542,2.3255813953488373,76,100,0.5652985074626866,-2.0,2.0,57.115671641791046,1,57,1,48.666666666666664,1.0,43.0,0.9661016949152542,1
52,Grigor Dimitrov,Bradley Klahn,52,1,0,58,54,42,28,57,55,43,30,0.5833333333333334,0.5384615384615384,0.3870967741935484,1,-1,-2,1.0175438596491229,2.380952380952381,82,100,0.5652985074626866,1.0,-2.0,57.115671641791046,1,58,1,42.0,0.0,42.0,1.0175438596491229,0
53,Yen-Hsun Lu,Jimmy Wang,53,1,0,63,32,37,12,62,33,38,11,0.4791666666666667,0.23076923076923078,0.3333333333333333,1,-1,1,1.0161290322580645,2.7027027027027026,44,100,0.5652985074626866,1.0,1.0,57.115671641791046,1,63,1,37.0,0.0,37.0,1.0161290322580645,0
54,Victor Hanescu,Peter Gojowczyk,54,1,0,55,44,45,22,66,60,34,23,0.6458333333333334,0.4230769230769231,0.2903225806451613,-11,-16,-1,0.8333333333333334,2.2222222222222223,66,100,0.5652985074626866,-11.0,-1.0,57.115671641791046,1,55,1,45.0,0.0,45.0,0.8333333333333334,0
55,Daniel Gimeno-Traver,Milos Raonic,55,1,1,64,56,36,17,56,43,44,25,0.4583333333333333,0.3269230769230769,0.3978494623655914,8,13,-8,1.1428571428571428,2.7777777777777777,73,100,0.5652985074626866,8.0,-8.0,57.115671641791046,1,64,1,31.5,1.0,36.0,1.1428571428571428,1
56,Kei Nishikori,Marinko Matosevic,56,1,0,61,69,39,29,66,68,34,25,0.5208333333333334,0.5576923076923077,0.2903225806451613,-5,1,4,0.9242424242424242,2.5641025641025643,98,100,0.5652985074626866,-5.0,4.0,57.115671641791046,1,61,1,40.0,0.0,39.0,0.9242424242424242,1
57,Lucas Pouille,Dusan Lajovic,57,1,1,61,53,39,30,61,55,39,22,0.5208333333333334,0.5769230769230769,0.34408602150537637,0,-2,8,1.0,2.5641025641025643,83,100,0.5652985074626866,0.0,8.0,57.115671641791046,1,61,1,39.0,1.0,39.0,1.0,0
58,Donald Young,Robin Haase,58,1,0,67,56,33,18,73,58,27,16,0.3958333333333333,0.34615384615384615,0.21505376344086022,-6,-2,2,0.9178082191780822,3.0303030303030303,74,100,0.5652985074626866,-6.0,2.0,57.115671641791046,1,67,1,37.5,0.0,33.0,0.9178082191780822,0
59,Lleyton Hewitt,Andreas Seppi,59,1,1,59,72,41,40,51,76,49,38,0.5625,0.7692307692307693,0.45161290322580644,8,-4,2,1.1568627450980393,2.4390243902439024,112,100,0.5652985074626866,8.0,2.0,57.115671641791046,1,59,1,40.4,1.0,41.0,1.1568627450980393,0
60,Gael Monfils,Ryan Harrison,60,1,0,62,42,38,17,64,43,36,18,0.5,0.3269230769230769,0.3118279569892473,-2,-1,-1,0.96875,2.6315789473684212,59,100,0.5652985074626866,-2.0,-1.0,57.115671641791046,1,62,1,38.0,0.0,38.0,0.96875,0
61,Jack Sock,Tobias Kamke,61,1,0,49,51,51,36,50,54,50,43,0.7708333333333334,0.6923076923076923,0.46236559139784944,-1,-3,-7,0.98,1.9607843137254901,87,100,0.5652985074626866,-1.0,-7.0,57.115671641791046,1,49,1,47.5,0.0,51.0,0.98,0
62,Igor Sijsling,Thanasi Kokkinakis,62,1,1,54,55,46,36,59,56,41,23,0.6666666666666666,0.6923076923076923,0.3655913978494624,-5,-1,13,0.9152542372881356,2.1739130434782608,91,100,0.5652985074626866,-5.0,13.0,57.115671641791046,1,54,1,46.0,1.0,46.0,0.9152542372881356,0
63,Bernard Tomic,Rafael Nadal,63,1,1,62,14,38,6,71,15,29,3,0.5,0.11538461538461539,0.23655913978494625,-9,-1,3,0.8732394366197183,2.6315789473684212,20,100,0.5652985074626866,-9.0,3.0,57.115671641791046,1,62,1,27.0,1.0,38.0,0.8732394366197183,0
64,Novak Djokovic,Leonardo Mayer,64,2,0,52,28,48,17,66,36,34,17,0.7083333333333334,0.3269230769230769,0.2903225806451613,-14,-8,0,0.7878787878787878,2.0833333333333335,45,100,-0.4467005076142132,-14.0,0.0,54.19796954314721,2,52,1,48.0,0.0,48.0,0.7878787878787878,0
65,Denis Istomin,Dmitry Tursunov,65,2,0,53,45,47,26,54,47,46,36,0.6875,0.5,0.41935483870967744,-1,-2,-10,0.9814814814814815,2.127659574468085,71,100,-0.4467005076142132,-1.0,-10.0,54.19796954314721,2,53,1,44.0,0.0,47.0,0.9814814814814815,0
66,Ernests Gulbis,Sam Querrey,66,2,1,72,45,28,11,46,23,54,21,0.2916666666666667,0.21153846153846154,0.5053763440860215,26,22,-10,1.565217391304348,3.5714285714285716,56,100,-0.4467005076142132,26.0,-10.0,54.19796954314721,2,72,1,28.0,1.0,28.0,1.565217391304348,1
67,Jarkko Nieminen,Fabio Fognini,67,2,1,58,62,42,30,65,57,35,23,0.5833333333333334,0.5769230769230769,0.3010752688172043,-7,5,7,0.8923076923076924,2.380952380952381,92,100,-0.4467005076142132,-7.0,7.0,54.19796954314721,2,58,1,42.0,1.0,42.0,0.8923076923076924,1
68,Richard Gasquet,Nikolay Davydenko,68,2,0,77,48,23,11,58,41,42,21,0.1875,0.21153846153846154,0.3763440860215054,19,7,-10,1.3275862068965518,4.3478260869565215,59,100,-0.4467005076142132,13.5,-10.0,54.19796954314721,3,77,2,23.0,0.0,23.0,1.3275862068965518,1
69,Julien Benneteau,Tommy Robredo,69,2,1,58,61,42,38,62,68,38,27,0.5833333333333334,0.7307692307692307,0.3333333333333333,-4,-7,11,0.9354838709677419,2.380952380952381,99,100,-0.4467005076142132,-4.0,11.0,54.19796954314721,2,58,1,42.0,1.0,42.0,0.9354838709677419,0
70,Vasek Pospisil,Matthew Ebden,70,2,0,68,64,32,19,60,59,40,31,0.375,0.36538461538461536,0.3548387096774194,8,5,-12,1.1333333333333333,3.125,83,100,-0.4467005076142132,8.0,-12.0,54.19796954314721,2,68,1,32.0,0.0,32.0,1.1333333333333333,1
71,Alejandro Falla,Stanislas Wawrinka,71,2,1,56,57,44,31,60,56,40,25,0.625,0.5961538461538461,0.3548387096774194,-4,1,6,0.9333333333333333,2.272727272727273,88,100,-0.4467005076142132,-4.0,6.0,54.19796954314721,2,56,1,39.0,1.0,44.0,0.9333333333333333,1
72,David Ferrer,Adrian Mannarino,72,2,0,55,44,45,25,68,56,32,18,0.6458333333333334,0.4807692307692308,0.26881720430107525,-13,-12,7,0.8088235294117647,2.2222222222222223,69,100,-0.4467005076142132,-13.0,7.0,54.19796954314721,2,55,1,45.0,0.0,45.0,0.8088235294117647,0
73,Alexandr Dolgopolov,Jeremy Chardy,73,2,1,60,74,40,30,71,81,29,22,0.5416666666666666,0.5769230769230769,0.23655913978494625,-11,-7,8,0.8450704225352113,2.5,104,100,-0.4467005076142132,-11.0,8.0,54.19796954314721,2,60,1,40.0,1.0,40.0,0.8450704225352113,0
74,Jerzy Janowicz,Pablo Andujar,74,2,0,79,71,21,20,67,76,33,25,0.14583333333333334,0.38461538461538464,0.27956989247311825,12,-5,-5,1.1791044776119404,4.761904761904762,91,100,-0.4467005076142132,12.0,-5.0,54.19796954314721,2,79,1,21.0,0.0,21.0,1.1791044776119404,0
75,Florian Mayer,Mikhail Youzhny,75,2,0,55,55,45,36,60,59,40,33,0.6458333333333334,0.6923076923076923,0.3548387096774194,-5,-4,3,0.9166666666666666,2.2222222222222223,91,100,-0.4467005076142132,-5.0,3.0,54.19796954314721,2,55,1,38.0,0.0,45.0,0.9166666666666666,0
76,Guillermo Garcia-Lopez,Edouard Roger-Vasselin,76,2,1,57,49,43,28,51,46,49,26,0.6041666666666666,0.5384615384615384,0.45161290322580644,6,3,2,1.1176470588235294,2.3255813953488373,77,100,-0.4467005076142132,6.0,2.0,54.19796954314721,2,57,1,43.0,1.0,43.0,1.1176470588235294,1
77,Dominic Thiem,Kevin Anderson,77,2,1,65,43,35,18,59,34,41,16,0.4375,0.34615384615384615,0.3655913978494624,6,9,2,1.1016949152542372,2.857142857142857,61,100,-0.4467005076142132,6.0,2.0,54.19796954314721,2,65,1,35.0,1.0,35.0,1.1016949152542372,1
78,Ivan Dodig,Damir Dzumhur,78,2,0,51,36,49,26,55,39,45,20,0.7291666666666666,0.5,0.40860215053763443,-4,-3,6,0.9272727272727272,2.0408163265306123,62,100,-0.4467005076142132,-4.0,6.0,54.19796954314721,2,51,1,49.0,0.0,49.0,0.9272727272727272,0
79,Kenny De Schepper,Tomas Berdych,79,2,1,64,37,36,15,63,33,37,10,0.4583333333333333,0.28846153846153844,0.3225806451612903,1,4,5,1.0158730158730158,2.7777777777777777,52,100,-0.4467005076142132,1.0,5.0,54.19796954314721,2,64,1,36.0,1.0,36.0,1.0158730158730158,1
80,Roger Federer,Blaz Kavcic,80,2,0,62,32,38,18,76,45,24,9,0.5,0.34615384615384615,0.1827956989247312,-14,-13,9,0.8157894736842105,2.6315789473684212,50,100,-0.4467005076142132,-14.0,9.0,54.19796954314721,2,62,1,38.0,0.0,38.0,0.8157894736842105,0
81,Teymuraz Gabashvili,Fernando Verdasco,81,2,0,60,67,40,34,68,62,32,26,0.5416666666666666,0.6538461538461539,0.26881720430107525,-8,5,8,0.8823529411764706,2.5,101,100,-0.4467005076142132,-8.0,8.0,54.19796954314721,2,60,1,41.0,0.0,40.0,0.8823529411764706,1
82,Gilles Simon,Marin Cilic,82,2,0,50,50,50,32,49,65,51,41,0.75,0.6153846153846154,0.4731182795698925,1,-15,-9,1.0204081632653061,2.0,82,100,-0.4467005076142132,1.0,-9.0,54.19796954314721,2,50,1,50.0,0.0,50.0,1.0204081632653061,0
83,Thomaz Bellucci,Jo-Wilfried Tsonga,83,2,1,64,51,36,18,45,31,55,34,0.4583333333333333,0.34615384615384615,0.5161290322580645,19,20,-16,1.4222222222222223,2.7777777777777777,69,100,-0.4467005076142132,19.0,-16.0,54.19796954314721,2,64,1,35.5,1.0,36.0,1.4222222222222223,1
84,Martin Klizan,Blaz Rola,84,2,0,63,66,37,24,58,49,42,34,0.4791666666666667,0.46153846153846156,0.3763440860215054,5,17,-10,1.0862068965517242,2.7027027027027026,90,100,-0.4467005076142132,5.0,-10.0,54.19796954314721,2,63,1,37.0,0.0,37.0,1.0862068965517242,1
85,Michal Przysiezny,Stephane Robert,85,2,1,58,56,42,30,58,50,42,24,0.5833333333333334,0.5769230769230769,0.3763440860215054,0,6,6,1.0,2.380952380952381,86,100,-0.4467005076142132,0.0,6.0,54.19796954314721,2,58,1,42.0,1.0,42.0,1.0,1
86,Feliciano Lopez,Michael Berrer,86,2,0,68,47,32,17,62,45,38,23,0.375,0.3269230769230769,0.3333333333333333,6,2,-6,1.096774193548387,3.125,64,100,-0.4467005076142132,6.0,-6.0,54.19796954314721,2,68,1,32.0,0.0,32.0,1.096774193548387,1
87,Vincent Millot,Andy Murray,87,2,1,59,35,41,17,55,25,45,20,0.5625,0.3269230769230769,0.40860215053763443,4,10,-3,1.0727272727272728,2.4390243902439024,52,100,-0.4467005076142132,4.0,-3.0,54.19796954314721,2,59,1,41.0,1.0,41.0,1.0727272727272728,1
88,Juan Martin Del Potro,Roberto Bautista Agut,88,2,1,69,88,31,23,72,76,28,21,0.3541666666666667,0.4423076923076923,0.22580645161290322,-3,12,2,0.9583333333333334,3.225806451612903,111,100,-0.4467005076142132,-3.0,2.0,54.19796954314721,2,69,1,26.0,1.0,31.0,0.9583333333333334,1
89,Nick Kyrgios,Benoit Paire,89,2,1,50,68,50,47,66,86,34,27,0.75,0.9038461538461539,0.2903225806451613,-16,-18,20,0.7575757575757576,2.0,115,100,-0.4467005076142132,-16.0,20.0,54.19796954314721,2,50,1,46.5,1.0,50.0,0.7575757575757576,0
90,Grigor Dimitrov,Yen-Hsun Lu,90,2,0,70,47,30,19,59,49,41,18,0.3333333333333333,0.36538461538461536,0.3655913978494624,11,-2,1,1.1864406779661016,3.3333333333333335,66,100,-0.4467005076142132,11.0,1.0,54.19796954314721,2,70,1,30.0,0.0,30.0,1.1864406779661016,0
91,Victor Hanescu,Milos Raonic,91,2,1,64,57,36,23,67,55,33,22,0.4583333333333333,0.4423076923076923,0.27956989247311825,-3,2,1,0.9552238805970149,2.7777777777777777,80,100,-0.4467005076142132,-3.0,1.0,54.19796954314721,2,64,1,36.5,1.0,36.0,0.9552238805970149,1
92,Kei Nishikori,Dusan Lajovic,92,2,0,70,37,30,8,64,43,36,15,0.3333333333333333,0.15384615384615385,0.3118279569892473,6,-6,-7,1.09375,3.3333333333333335,45,100,-0.4467005076142132,6.0,-7.0,54.19796954314721,2,70,1,30.0,0.0,30.0,1.09375,0
93,Donald Young,Andreas Seppi,93,2,0,57,57,43,33,61,71,39,29,0.6041666666666666,0.6346153846153846,0.34408602150537637,-4,-14,4,0.9344262295081968,2.3255813953488373,90,100,-0.4467005076142132,-4.0,4.0,54.19796954314721,2,57,1,43.0,0.0,43.0,0.9344262295081968,0
94,Gael Monfils,Jack Sock,94,2,0,58,48,42,23,62,47,38,23,0.5833333333333334,0.4423076923076923,0.3333333333333333,-4,1,0,0.9354838709677419,2.380952380952381,71,100,-0.4467005076142132,-4.0,0.0,54.19796954314721,2,58,1,42.0,0.0,42.0,0.9354838709677419,1
95,Thanasi Kokkinakis,Rafael Nadal,95,2,1,74,45,26,11,67,33,33,10,0.25,0.21153846153846154,0.27956989247311825,7,12,1,1.1044776119402986,3.8461538461538463,56,100,-0.4467005076142132,7.0,1.0,54.19796954314721,2,74,1,26.0,1.0,26.0,1.1044776119402986,1
96,Novak Djokovic,Denis Istomin,96,3,0,65,41,35,10,63,38,37,20,0.4375,0.19230769230769232,0.3225806451612903,2,3,-10,1.0317460317460319,2.857142857142857,51,100,0.037383177570093455,2.0,-10.0,50.467289719626166,3,65,1,35.0,0.0,35.0,1.0317460317460319,1
97,Sam Querrey,Fabio Fognini,97,3,1,60,41,40,26,63,43,37,19,0.5416666666666666,0.5,0.3225806451612903,-3,-2,7,0.9523809523809523,2.5,67,100,0.037383177570093455,-3.0,7.0,50.467289719626166,3,60,1,40.0,1.0,40.0,0.9523809523809523,0
98,Richard Gasquet,Tommy Robredo,98,3,1,65,70,35,21,62,61,38,28,0.4375,0.40384615384615385,0.3333333333333333,3,9,-7,1.0483870967741935,2.857142857142857,91,100,0.037383177570093455,3.0,-7.0,50.467289719626166,3,65,1,35.0,1.0,35.0,1.0483870967741935,1
99,David Ferrer,Jeremy Chardy,99,3,0,58,44,42,17,72,44,28,17,0.5833333333333334,0.3269230769230769,0.22580645161290322,-14,0,0,0.8055555555555556,2.380952380952381,61,100,0.037383177570093455,-14.0,0.0,50.467289719626166,3,58,1,42.0,0.0,42.0,0.8055555555555556,0
100,Jerzy Janowicz,Florian Mayer,100,3,1,68,42,32,15,53,34,47,18,0.375,0.28846153846153844,0.43010752688172044,15,8,-3,1.2830188679245282,3.125,57,100,0.037383177570093455,15.0,-3.0,50.467289719626166,3,68,1,32.0,1.0,32.0,1.2830188679245282,1
101,Edouard Roger-Vasselin,Kevin Anderson,101,3,1,67,77,33,26,74,94,26,20,0.3958333333333333,0.5,0.20430107526881722,-7,-17,6,0.9054054054054054,3.0303030303030303,103,100,0.037383177570093455,-7.0,6.0,50.467289719626166,3,67,1,33.0,1.0,33.0,0.9054054054054054,0
102,Damir Dzumhur,Tomas Berdych,102,3,1,57,37,43,19,44,25,56,17,0.6041666666666666,0.36538461538461536,0.5268817204301075,13,12,2,1.2954545454545454,2.3255813953488373,56,100,0.037383177570093455,13.0,2.0,50.467289719626166,3,57,1,43.0,1.0,43.0,1.2954545454545454,1
103,Roger Federer,Teymuraz Gabashvili,103,3,0,69,38,31,10,62,39,38,16,0.3541666666666667,0.19230769230769232,0.3333333333333333,7,-1,-6,1.1129032258064515,3.225806451612903,48,100,0.037383177570093455,7.0,-6.0,50.467289719626166,3,69,1,31.0,0.0,31.0,1.1129032258064515,0
104,Gilles Simon,Jo-Wilfried Tsonga,104,3,1,66,49,34,20,53,34,47,22,0.4166666666666667,0.38461538461538464,0.43010752688172044,13,15,-2,1.2452830188679245,2.9411764705882355,69,100,0.037383177570093455,13.0,-2.0,50.467289719626166,3,66,1,33.5,1.0,34.0,1.2452830188679245,1
105,Martin Klizan,Stephane Robert,105,3,1,72,54,28,11,53,32,47,21,0.2916666666666667,0.21153846153846154,0.43010752688172044,19,22,-10,1.3584905660377358,3.5714285714285716,65,100,0.037383177570093455,19.0,-10.0,50.467289719626166,3,72,1,28.0,1.0,28.0,1.3584905660377358,1
106,Feliciano Lopez,Andy Murray,106,3,1,64,50,36,16,57,39,43,20,0.4583333333333333,0.3076923076923077,0.3870967741935484,7,11,-4,1.1228070175438596,2.7777777777777777,66,100,0.037383177570093455,7.0,-4.0,50.467289719626166,3,64,1,36.0,1.0,36.0,1.1228070175438596,1
107,Roberto Bautista Agut,Benoit Paire,107,3,0,58,30,42,10,83,46,17,7,0.5833333333333334,0.19230769230769232,0.10752688172043011,-25,-16,3,0.6987951807228916,2.380952380952381,40,100,0.037383177570093455,-25.0,3.0,50.467289719626166,3,58,1,49.5,0.0,42.0,0.6987951807228916,0
108,Grigor Dimitrov,Milos Raonic,108,3,0,59,55,41,30,60,55,40,33,0.5625,0.5769230769230769,0.3548387096774194,-1,0,-3,0.9833333333333333,2.4390243902439024,85,100,0.037383177570093455,-1.0,-3.0,50.467289719626166,3,59,1,42.0,0.0,41.0,0.9833333333333333,0
109,Kei Nishikori,Donald Young,109,3,0,64,23,36,7,54,29,46,21,0.4583333333333333,0.1346153846153846,0.41935483870967744,10,-6,-14,1.1851851851851851,2.7777777777777777,30,100,0.037383177570093455,10.0,-14.0,50.467289719626166,3,64,1,36.0,0.0,36.0,1.1851851851851851,0
110,Gael Monfils,Rafael Nadal,110,3,1,67,38,33,20,69,39,31,10,0.3958333333333333,0.38461538461538464,0.25806451612903225,-2,-1,10,0.9710144927536232,3.0303030303030303,58,100,0.037383177570093455,-2.0,10.0,50.467289719626166,3,67,1,27.5,1.0,33.0,0.9710144927536232,0
111,Novak Djokovic,Fabio Fognini,111,4,0,59,32,41,13,72,38,28,12,0.5625,0.25,0.22580645161290322,-13,-6,1,0.8194444444444444,2.4390243902439024,45,100,0.38181818181818183,-13.0,1.0,55.54545454545455,4,59,1,41.0,0.0,41.0,0.8194444444444444,0
112,Tommy Robredo,Stanislas Wawrinka,112,4,1,56,54,44,24,71,53,29,14,0.625,0.46153846153846156,0.23655913978494625,-15,1,10,0.7887323943661971,2.272727272727273,78,100,0.38181818181818183,-15.0,10.0,55.54545454545455,4,56,1,40.5,1.0,44.0,0.7887323943661971,1
113,David Ferrer,Florian Mayer,113,4,0,61,52,39,27,63,55,37,24,0.5208333333333334,0.5192307692307693,0.3225806451612903,-2,-3,3,0.9682539682539683,2.5641025641025643,79,100,0.38181818181818183,-2.0,3.0,55.54545454545455,4,61,1,39.0,0.0,39.0,0.9682539682539683,0
114,Kevin Anderson,Tomas Berdych,114,4,1,52,33,48,21,72,40,28,9,0.7083333333333334,0.40384615384615385,0.22580645161290322,-20,-7,12,0.7222222222222222,2.0833333333333335,54,100,0.38181818181818183,-20.0,12.0,55.54545454545455,4,52,1,48.0,1.0,48.0,0.7222222222222222,0
115,Roger Federer,Jo-Wilfried Tsonga,115,4,0,52,32,48,23,57,42,43,25,0.7083333333333334,0.4423076923076923,0.3870967741935484,-5,-10,-2,0.9122807017543859,2.0833333333333335,55,100,0.38181818181818183,1.5,-3.0,55.54545454545455,5,75,2,35.5,0.5,48.0,0.9122807017543859,0
116,Stephane Robert,Andy Murray,116,4,1,62,59,38,25,51,39,49,22,0.5,0.4807692307692308,0.45161290322580644,11,20,3,1.2156862745098038,2.6315789473684212,84,100,0.38181818181818183,11.0,3.0,55.54545454545455,4,62,1,38.0,1.0,38.0,1.2156862745098038,1
117,Roberto Bautista Agut,Grigor Dimitrov,117,4,1,60,57,40,21,64,44,36,22,0.5416666666666666,0.40384615384615385,0.3118279569892473,-4,13,-1,0.9375,2.5,78,100,0.38181818181818183,-4.0,-1.0,55.54545454545455,4,60,1,40.0,1.0,40.0,0.9375,1
118,Kei Nishikori,Rafael Nadal,118,4,1,71,67,29,14,66,51,34,16,0.3125,0.2692307692307692,0.2903225806451613,5,16,-2,1.0757575757575757,3.4482758620689653,81,100,0.38181818181818183,4.5,-0.5,55.54545454545455,4,71,2,30.0,1.0,30.0,1.0686480186480187,1
119,Novak Djokovic,Stanislas Wawrinka,119,5,1,58,71,42,36,73,75,27,23,0.5833333333333334,0.6923076923076923,0.21505376344086022,-15,-4,13,0.7945205479452054,2.380952380952381,107,100,-1.2222222222222223,-15.0,13.0,54.333333333333336,5,58,1,42.0,1.0,42.0,0.7945205479452054,0
120,David Ferrer,Tomas Berdych,120,5,1,52,52,48,27,61,46,39,23,0.7083333333333334,0.5192307692307693,0.34408602150537637,-9,6,4,0.8524590163934426,2.0833333333333335,79,100,-1.2222222222222223,-9.0,4.0,54.333333333333336,5,52,1,48.0,1.0,48.0,0.8524590163934426,1
121,Roger Federer,Andy Murray,121,5,0,61,60,39,28,64,61,36,28,0.5208333333333334,0.5384615384615384,0.3118279569892473,-3,-1,0,0.953125,2.5641025641025643,88,100,-1.2222222222222223,-3.0,0.0,54.333333333333336,5,61,1,39.0,0.0,39.0,0.953125,0
122,Grigor Dimitrov,Rafael Nadal,122,5,1,73,66,27,22,58,64,42,32,0.2708333333333333,0.4230769230769231,0.3763440860215054,15,2,-10,1.2586206896551724,3.7037037037037037,88,100,-1.2222222222222223,15.0,-10.0,54.333333333333336,5,73,1,26.0,1.0,27.0,1.2586206896551724,1
123,Stanislas Wawrinka,Tomas Berdych,123,6,0,62,71,38,30,61,72,39,32,0.5,0.5769230769230769,0.34408602150537637,1,-1,-2,1.0163934426229508,2.6315789473684212,101,100,-3.2857142857142856,1.0,-2.0,57.357142857142854,6,62,1,38.0,0.0,38.0,1.0163934426229508,0
124,Roger Federer,Rafael Nadal,124,6,1,65,41,35,22,66,45,34,18,0.4375,0.4230769230769231,0.2903225806451613,-1,-4,4,0.9848484848484849,2.857142857142857,63,100,-3.2857142857142856,-1.0,4.0,57.357142857142854,6,65,1,35.0,1.0,35.0,0.9848484848484849,0
125,Stanislas Wawrinka,Rafael Nadal,125,7,0,78,50,22,10,55,46,45,22,0.16666666666666666,0.19230769230769232,0.40860215053763443,23,4,-12,1.4181818181818182,4.545454545454546,60,100,5.285714285714286,19.0,-6.5,47.857142857142854,7,78,2,26.0,0.5,22.0,1.4181818181818182,1
126,Ashleigh Barty,Serena Williams,126,1,1,59,20,41,8,51,14,49,11,0.5625,0.15384615384615385,0.45161290322580644,8,6,-3,1.1568627450980393,2.4390243902439024,28,100,0.5652985074626866,8.0,-3.0,57.115671641791046,1,59,1,34.0,1.0,41.0,1.1568627450980393,1
127,Lara Arruabarrena,Vesna Dolonc,127,1,1,65,33,35,10,62,33,38,10,0.4375,0.19230769230769232,0.3333333333333333,3,0,0,1.0483870967741935,2.857142857142857,43,100,0.5652985074626866,3.0,0.0,57.115671641791046,1,65,1,35.0,1.0,35.0,1.0483870967741935,0
128,Karolina Pliskova,Pauline Parmentier,128,1,0,63,16,37,4,60,26,40,7,0.4791666666666667,0.07692307692307693,0.3548387096774194,3,-10,-3,1.05,2.7027027027027026,20,100,0.5652985074626866,3.0,-3.0,57.115671641791046,1,63,1,41.5,0.0,37.0,1.05,0
129,Daniela Hantuchova,Heather Watson,129,1,0,61,41,39,19,68,43,32,10,0.5208333333333334,0.36538461538461536,0.26881720430107525,-7,-2,9,0.8970588235294118,2.5641025641025643,60,100,0.5652985074626866,-7.0,9.0,57.115671641791046,1,61,1,39.0,0.0,39.0,0.8970588235294118,0
130,Klara Zakopalova,Samantha Stosur,130,1,1,65,28,35,11,50,18,50,7,0.4375,0.21153846153846154,0.46236559139784944,15,10,4,1.3,2.857142857142857,39,100,0.5652985074626866,15.0,4.0,57.115671641791046,1,65,1,35.0,1.0,35.0,1.3,1
131,Silvia Soler-Espinosa,Tsvetana Pironkova,131,1,1,62,28,38,12,50,18,50,14,0.5,0.23076923076923078,0.46236559139784944,12,10,-2,1.24,2.6315789473684212,40,100,0.5652985074626866,12.0,-2.0,57.115671641791046,1,62,1,38.0,1.0,38.0,1.24,1
132,Petra Martic,Annika Beck,132,1,1,67,18,33,8,50,8,50,4,0.3958333333333333,0.15384615384615385,0.46236559139784944,17,10,4,1.34,3.0303030303030303,26,100,0.5652985074626866,17.0,4.0,57.115671641791046,1,67,1,33.0,1.0,33.0,1.34,1
133,Ana Ivanovic,Kiki Bertens,133,1,0,61,15,39,11,60,24,40,9,0.5208333333333334,0.21153846153846154,0.3548387096774194,1,-9,2,1.0166666666666666,2.5641025641025643,26,100,0.5652985074626866,1.0,2.0,57.115671641791046,1,61,1,38.0,0.0,39.0,1.0166666666666666,0
134,Jie Zheng,Roberta Vinci,134,1,0,66,23,34,7,68,26,32,10,0.4166666666666667,0.1346153846153846,0.26881720430107525,-2,-3,-3,0.9705882352941176,2.9411764705882355,30,100,0.5652985074626866,-2.0,-3.0,57.115671641791046,1,66,1,34.0,0.0,34.0,0.9705882352941176,0
135,Madison Keys,Patricia Mayr-Achleitner,135,1,0,71,48,29,14,52,45,48,30,0.3125,0.2692307692307692,0.44086021505376344,19,3,-16,1.3653846153846154,3.4482758620689653,62,100,0.5652985074626866,19.0,-16.0,57.115671641791046,1,71,1,29.0,0.0,29.0,1.3653846153846154,1
136,Vera Zvonareva,Casey Dellacqua,136,1,1,66,22,34,13,65,22,35,9,0.4166666666666667,0.25,0.3010752688172043,1,0,4,1.0153846153846153,2.9411764705882355,35,100,0.5652985074626866,1.0,4.0,57.115671641791046,1,66,1,34.0,1.0,34.0,1.0153846153846153,0
137,Kirsten Flipkens,Laura Robson,137,1,0,57,14,43,5,57,18,43,11,0.6041666666666666,0.09615384615384616,0.3870967741935484,0,-4,-6,1.0,2.3255813953488373,19,100,0.5652985074626866,0.0,-6.0,57.115671641791046,1,57,1,43.0,0.0,43.0,1.0,0
138,Hao Chen Tang,Eugenie Bouchard,138,1,1,64,30,36,16,57,21,43,12,0.4583333333333333,0.3076923076923077,0.3870967741935484,7,9,4,1.1228070175438596,2.7777777777777777,46,100,0.5652985074626866,7.0,4.0,57.115671641791046,1,64,1,39.5,1.0,36.0,1.1228070175438596,1
139,Virginie Razzano,Alison Van Uytvanck,139,1,0,54,32,46,15,58,39,42,18,0.6666666666666666,0.28846153846153844,0.3763440860215054,-4,-7,-3,0.9310344827586207,2.1739130434782608,47,100,0.5652985074626866,-4.0,-3.0,57.115671641791046,1,54,1,46.0,0.0,46.0,0.9310344827586207,0
140,Lauren Davis,Sachia Vickery,140,1,0,51,14,49,12,61,23,39,7,0.7291666666666666,0.23076923076923078,0.34408602150537637,-10,-9,5,0.8360655737704918,2.0408163265306123,26,100,0.5652985074626866,-10.0,5.0,57.115671641791046,1,51,1,49.0,0.0,49.0,0.8360655737704918,0
141,Sara Errani,Julia Goerges,141,1,1,50,20,50,15,77,21,23,5,0.75,0.28846153846153844,0.17204301075268819,-27,-1,10,0.6493506493506493,2.0,35,100,0.5652985074626866,-27.0,10.0,57.115671641791046,1,50,1,48.0,1.0,50.0,0.6493506493506493,0
142,Ana Konjuh,Na Li,142,1,1,76,24,24,7,50,13,50,9,0.20833333333333334,0.1346153846153846,0.46236559139784944,26,11,-2,1.52,4.166666666666667,31,100,0.5652985074626866,26.0,-2.0,57.115671641791046,1,76,1,26.5,1.0,24.0,1.52,1
143,Kimiko Date-Krumm,Belinda Bencic,143,1,1,53,25,47,15,71,31,29,10,0.6875,0.28846153846153844,0.23655913978494625,-18,-6,5,0.7464788732394366,2.127659574468085,40,100,0.5652985074626866,-18.0,5.0,57.115671641791046,1,53,1,47.0,1.0,47.0,0.7464788732394366,0
144,Lucie Hradecka,Donna Vekic,144,1,0,47,17,53,9,54,23,46,12,0.8125,0.17307692307692307,0.41935483870967744,-7,-6,-3,0.8703703703703703,1.8867924528301887,26,100,0.5652985074626866,-7.0,-3.0,57.115671641791046,1,47,1,53.0,0.0,53.0,0.8703703703703703,0
145,Lucie Safarova,Julia Glushko,145,1,0,61,35,39,20,59,37,41,21,0.5208333333333334,0.38461538461538464,0.3655913978494624,2,-2,-1,1.0338983050847457,2.5641025641025643,55,100,0.5652985074626866,2.0,-1.0,57.115671641791046,1,61,1,39.0,0.0,39.0,1.0338983050847457,0
146,Venus Williams,Ekaterina Makarova,146,1,1,63,43,37,17,55,36,45,18,0.4791666666666667,0.3269230769230769,0.40860215053763443,8,7,-1,1.1454545454545455,2.7027027027027026,60,100,0.5652985074626866,8.0,-1.0,57.115671641791046,1,63,1,37.0,1.0,37.0,1.1454545454545455,1
147,Irina Falconi,Anabel Medina Garrigues,147,1,0,86,18,14,3,53,18,47,13,0.0,0.057692307692307696,0.43010752688172044,33,0,-10,1.6226415094339623,7.142857142857143,21,100,0.5652985074626866,33.0,-10.0,57.115671641791046,1,86,1,14.0,0.0,14.0,1.6226415094339623,0
148,Monica Niculescu,Shahar Peer,148,1,0,80,21,20,2,82,26,18,3,0.125,0.038461538461538464,0.11827956989247312,-2,-5,-1,0.975609756097561,5.0,23,100,0.5652985074626866,-2.0,-1.0,57.115671641791046,1,80,1,20.0,0.0,20.0,0.975609756097561,0
149,Sabine Lisicki,Mirjana Lucic-Baroni,149,1,0,43,17,57,8,52,32,48,15,0.8958333333333334,0.15384615384615385,0.44086021505376344,-9,-15,-7,0.8269230769230769,1.7543859649122806,25,100,0.5652985074626866,-9.0,-7.0,57.115671641791046,1,43,1,57.0,0.0,57.0,0.8269230769230769,0
150,Jarmila Gajdosova,Angelique Kerber,150,1,1,65,36,35,13,53,29,47,12,0.4375,0.25,0.43010752688172044,12,7,1,1.2264150943396226,2.857142857142857,49,100,0.5652985074626866,12.0,1.0,57.115671641791046,1,65,1,35.0,1.0,35.0,1.2264150943396226,1
151,Alla Kudryavtseva,Caroline Garcia,151,1,0,58,22,42,15,58,37,42,14,0.5833333333333334,0.28846153846153844,0.3763440860215054,0,-15,1,1.0,2.380952380952381,37,100,0.5652985074626866,0.0,1.0,57.115671641791046,1,58,1,42.0,0.0,42.0,1.0,0
152,Yanina Wickmayer,Dinah Pfizenmaier,152,1,0,48,24,52,23,58,38,42,15,0.7916666666666666,0.4423076923076923,0.3763440860215054,-10,-14,8,0.8275862068965517,1.9230769230769231,47,100,0.5652985074626866,-10.0,8.0,57.115671641791046,1,48,1,42.5,0.0,52.0,0.8275862068965517,0
153,Elena Vesnina,Alison Riske,153,1,1,64,24,36,8,62,17,38,10,0.4583333333333333,0.15384615384615385,0.3333333333333333,2,7,-2,1.032258064516129,2.7777777777777777,32,100,0.5652985074626866,2.0,-2.0,57.115671641791046,1,64,1,36.0,1.0,36.0,1.032258064516129,1
154,Alexandra Cadantu,Flavia Pennetta,154,1,1,40,16,60,14,58,14,42,9,0.9583333333333334,0.2692307692307692,0.3763440860215054,-18,2,5,0.6896551724137931,1.6666666666666667,30,100,0.5652985074626866,-18.0,5.0,57.115671641791046,1,40,1,59.5,1.0,60.0,0.6896551724137931,1
155,Anna Tatishvili,Monica Puig,155,1,1,61,30,39,13,68,20,32,5,0.5208333333333334,0.25,0.26881720430107525,-7,10,8,0.8970588235294118,2.5641025641025643,43,100,0.5652985074626866,-7.0,8.0,57.115671641791046,1,61,1,39.0,1.0,39.0,0.8970588235294118,1
156,Mona Barthel,Shuai Zhang,156,1,0,75,31,25,8,69,41,31,10,0.22916666666666666,0.15384615384615385,0.25806451612903225,6,-10,-2,1.0869565217391304,4.0,39,100,0.5652985074626866,6.0,-2.0,57.115671641791046,1,75,1,25.0,0.0,25.0,1.0869565217391304,0
157,Petra Kvitova,Luksika Kumkhum,157,1,1,48,26,52,20,60,36,40,15,0.7916666666666666,0.38461538461538464,0.3548387096774194,-12,-10,5,0.8,1.9230769230769231,46,100,0.5652985074626866,-12.0,5.0,57.115671641791046,1,48,1,52.0,1.0,52.0,0.8,0
158,Misaki Doi,Jelena Jankovic,158,1,1,60,23,40,11,52,12,48,5,0.5416666666666666,0.21153846153846154,0.44086021505376344,8,11,6,1.1538461538461537,2.5,34,100,0.5652985074626866,8.0,6.0,57.115671641791046,1,60,1,31.0,1.0,40.0,1.1538461538461537,1
159,Ayumi Morita,Nadiya Kichenok,159,1,0,63,27,37,11,62,30,38,16,0.4791666666666667,0.21153846153846154,0.3333333333333333,1,-3,-5,1.0161290322580645,2.7027027027027026,38,100,0.5652985074626866,1.0,-5.0,57.115671641791046,1,63,1,37.0,0.0,37.0,1.0161290322580645,0
160,Shuai Peng,Kurumi Nara,160,1,1,74,39,26,10,63,40,37,16,0.25,0.19230769230769232,0.3225806451612903,11,-1,-6,1.1746031746031746,3.8461538461538463,49,100,0.5652985074626866,11.0,-6.0,57.115671641791046,1,74,1,26.0,1.0,26.0,1.1746031746031746,0
161,Magdalena Rybarikova,Andrea Petkovic,161,1,0,68,23,32,6,67,27,33,8,0.375,0.11538461538461539,0.27956989247311825,1,-4,-2,1.0149253731343284,3.125,29,100,0.5652985074626866,1.0,-2.0,57.115671641791046,1,68,1,32.0,0.0,32.0,1.0149253731343284,0
162,Marina Erakovic,Sorana Cirstea,162,1,0,57,25,43,13,59,35,41,17,0.6041666666666666,0.25,0.3655913978494624,-2,-10,-4,0.9661016949152542,2.3255813953488373,38,100,0.5652985074626866,-2.0,-4.0,57.115671641791046,1,57,1,43.0,0.0,43.0,0.9661016949152542,0
163,Katerina Siniakova,Zarina Diyas,163,1,1,74,33,26,6,57,22,43,10,0.25,0.11538461538461539,0.3870967741935484,17,11,-4,1.2982456140350878,3.8461538461538463,39,100,0.5652985074626866,17.0,-4.0,57.115671641791046,1,74,1,26.0,1.0,26.0,1.2982456140350878,1
164,Varvara Lepchenko,Lesia Tsurenko,164,1,0,63,35,37,20,64,42,36,15,0.4791666666666667,0.38461538461538464,0.3118279569892473,-1,-7,5,0.984375,2.7027027027027026,55,100,0.5652985074626866,-1.0,5.0,57.115671641791046,1,63,1,37.0,0.0,37.0,0.984375,0
165,Simona Halep,Katarzyna Piter,165,1,0,77,12,23,1,61,21,39,9,0.1875,0.019230769230769232,0.34408602150537637,16,-9,-8,1.2622950819672132,4.3478260869565215,13,100,0.5652985074626866,16.0,-8.0,57.115671641791046,1,77,1,23.0,0.0,23.0,1.2622950819672132,0
166,Vania King,Carla Suarez Navarro,166,1,1,79,31,21,4,69,20,31,5,0.14583333333333334,0.07692307692307693,0.25806451612903225,10,11,-1,1.144927536231884,4.761904761904762,35,100,0.5652985074626866,10.0,-1.0,57.115671641791046,1,79,1,21.0,1.0,21.0,1.144927536231884,1
167,Irina-Camelia Begu,Galina Voskoboeva,167,1,1,64,41,36,18,62,44,38,15,0.4583333333333333,0.34615384615384615,0.3333333333333333,2,-3,3,1.032258064516129,2.7777777777777777,59,100,0.5652985074626866,2.0,3.0,57.115671641791046,1,64,1,40.5,1.0,36.0,1.032258064516129,0
168,Stefanie Voegele,Kristina Mladenovic,168,1,0,48,29,52,19,66,32,34,13,0.7916666666666666,0.36538461538461536,0.2903225806451613,-18,-3,6,0.7272727272727273,1.9230769230769231,48,100,0.5652985074626866,-18.0,6.0,57.115671641791046,1,48,1,47.0,0.0,52.0,0.7272727272727273,0
169,Dominika Cibulkova,Francesca Schiavone,169,1,0,60,21,40,11,61,33,39,14,0.5416666666666666,0.21153846153846154,0.34408602150537637,-1,-12,-3,0.9836065573770492,2.5,32,100,0.5652985074626866,-1.0,-3.0,57.115671641791046,1,60,1,40.0,0.0,40.0,0.9836065573770492,0
170,Polona Hercog,Alize Cornet,170,1,0,75,3,25,1,0,0,100,1,0.22916666666666666,0.019230769230769232,1.0,0,0,0,0.0,4.0,4,100,0.5652985074626866,0.0,0.0,57.115671641791046,1,75,1,27.5,0.0,25.0,0.0,1
171,Storm Sanders,Camila Giorgi,171,1,1,51,38,49,23,63,35,37,12,0.7291666666666666,0.4423076923076923,0.3225806451612903,-12,3,11,0.8095238095238095,2.0408163265306123,61,100,0.5652985074626866,-12.0,11.0,57.115671641791046,1,51,1,49.0,1.0,49.0,0.8095238095238095,1
172,Karin Knapp,Paula Ormaechea,172,1,0,57,26,43,7,61,26,39,8,0.6041666666666666,0.1346153846153846,0.34408602150537637,-4,0,-1,0.9344262295081968,2.3255813953488373,33,100,0.5652985074626866,-4.0,-1.0,57.115671641791046,1,57,1,43.0,0.0,43.0,0.9344262295081968,0
173,Maria Sharapova,Bethanie Mattek-Sands,173,1,0,57,27,43,10,53,31,47,13,0.6041666666666666,0.19230769230769232,0.43010752688172044,4,-4,-3,1.0754716981132075,2.3255813953488373,37,100,0.5652985074626866,4.0,-3.0,57.115671641791046,1,57,1,44.5,0.0,43.0,1.0754716981132075,0
174,Yulia Putintseva,Agnieszka Radwanska,174,1,1,59,36,41,15,52,29,48,16,0.5625,0.28846153846153844,0.44086021505376344,7,7,-1,1.1346153846153846,2.4390243902439024,51,100,0.5652985074626866,7.0,-1.0,57.115671641791046,1,59,1,37.0,1.0,41.0,1.1346153846153846,1
175,Ying-Ying Duan,Olga Govortsova,175,1,1,68,35,32,8,60,24,40,16,0.375,0.15384615384615385,0.3548387096774194,8,11,-8,1.1333333333333333,3.125,43,100,0.5652985074626866,8.0,-8.0,57.115671641791046,1,68,1,32.0,1.0,32.0,1.1333333333333333,1
176,Mandy Minella,Carina Witthoeft,176,1,0,62,16,38,10,56,17,44,16,0.5,0.19230769230769232,0.3978494623655914,6,-1,-6,1.1071428571428572,2.6315789473684212,26,100,0.5652985074626866,6.0,-6.0,57.115671641791046,1,62,1,38.0,0.0,38.0,1.1071428571428572,0
177,Anastasia Pavlyuchenkova,Teliana Pereira,177,1,0,68,43,32,14,62,32,38,15,0.375,0.2692307692307692,0.3333333333333333,6,11,-1,1.096774193548387,3.125,57,100,0.5652985074626866,6.0,-1.0,57.115671641791046,1,68,1,32.0,0.0,32.0,1.096774193548387,1
178,Garbine Muguruza,Kaia Kanepi,178,1,0,64,27,36,12,51,28,49,20,0.4583333333333333,0.23076923076923078,0.45161290322580644,13,-1,-8,1.2549019607843137,2.7777777777777777,39,100,0.5652985074626866,13.0,-8.0,57.115671641791046,1,64,1,36.0,0.0,36.0,1.2549019607843137,0
179,Anna Schmiedlova,Timea Babos,179,1,0,60,46,40,17,66,54,34,23,0.5416666666666666,0.3269230769230769,0.2903225806451613,-6,-8,-6,0.9090909090909091,2.5,63,100,0.5652985074626866,-6.0,-6.0,57.115671641791046,1,60,1,40.0,0.0,40.0,0.9090909090909091,0
180,Yung-Jan Chan,Christina McHale,180,1,1,71,31,29,11,68,28,32,10,0.3125,0.21153846153846154,0.26881720430107525,3,3,1,1.0441176470588236,3.4482758620689653,42,100,0.5652985074626866,3.0,1.0,57.115671641791046,1,71,1,29.0,1.0,29.0,1.0441176470588236,1
181,Caroline Wozniacki,Lourdes Dominguez Lino,181,1,0,58,10,42,8,61,17,39,11,0.5833333333333334,0.15384615384615385,0.34408602150537637,-3,-7,-3,0.9508196721311475,2.380952380952381,18,100,0.5652985074626866,-3.0,-3.0,57.115671641791046,1,58,1,42.0,0.0,42.0,0.9508196721311475,0
182,Yaroslava Shvedova,Sloane Stephens,182,1,1,75,31,25,7,58,22,42,10,0.22916666666666666,0.1346153846153846,0.3763440860215054,17,9,-3,1.293103448275862,4.0,38,100,0.5652985074626866,17.0,-3.0,57.115671641791046,1,75,1,25.0,1.0,25.0,1.293103448275862,1
183,Ajla Tomljanovic,Tadeja Majeric,183,1,0,72,54,28,10,49,36,51,25,0.2916666666666667,0.19230769230769232,0.4731182795698925,23,18,-15,1.469387755102041,3.5714285714285716,64,100,0.5652985074626866,23.0,-15.0,57.115671641791046,1,72,1,28.0,0.0,28.0,1.469387755102041,1
184,Mariana Duque-Marino,Olivia Rogowska,184,1,1,63,25,37,10,67,18,33,5,0.4791666666666667,0.19230769230769232,0.27956989247311825,-4,7,5,0.9402985074626866,2.7027027027027026,35,100,0.5652985074626866,-4.0,5.0,57.115671641791046,1,63,1,37.0,1.0,37.0,0.9402985074626866,1
185,Svetlana Kuznetsova,Elina Svitolina,185,1,1,61,26,39,8,48,20,52,11,0.5208333333333334,0.15384615384615385,0.4838709677419355,13,6,-3,1.2708333333333333,2.5641025641025643,34,100,0.5652985074626866,13.0,-3.0,57.115671641791046,1,61,1,39.0,1.0,39.0,1.2708333333333333,1
186,Jana Cepelova,Bojana Jovanovski,186,1,1,76,43,24,11,69,28,31,7,0.20833333333333334,0.21153846153846154,0.25806451612903225,7,15,4,1.1014492753623188,4.166666666666667,54,100,0.5652985074626866,7.0,4.0,57.115671641791046,1,76,1,24.0,1.0,24.0,1.1014492753623188,1
187,Yvonne Meusburger,Chanelle Scheepers,187,1,0,53,27,47,12,68,32,32,12,0.6875,0.23076923076923078,0.26881720430107525,-15,-5,0,0.7794117647058824,2.127659574468085,39,100,0.5652985074626866,-15.0,0.0,57.115671641791046,1,53,1,46.5,0.0,47.0,0.7794117647058824,0
188,Barbora Zahlavova Strycova,Su-Wei Hsieh,188,1,0,58,33,42,15,68,39,32,13,0.5833333333333334,0.28846153846153844,0.26881720430107525,-10,-6,2,0.8529411764705882,2.380952380952381,48,100,0.5652985074626866,-10.0,2.0,57.115671641791046,1,58,1,40.0,0.0,42.0,0.8529411764705882,0
189,Victoria Azarenka,Johanna Larsson,189,1,0,72,24,28,5,75,41,25,4,0.2916666666666667,0.09615384615384616,0.1935483870967742,-3,-17,1,0.96,3.5714285714285716,29,100,0.5652985074626866,-3.0,1.0,57.115671641791046,1,72,1,28.0,0.0,28.0,0.96,0
190,Vesna Dolonc,Serena Williams,190,2,1,66,28,34,8,54,17,46,6,0.4166666666666667,0.15384615384615385,0.41935483870967744,12,11,2,1.2222222222222223,2.9411764705882355,36,100,-0.4467005076142132,12.0,2.0,54.19796954314721,2,66,1,32.5,1.0,34.0,1.2222222222222223,1
191,Daniela Hantuchova,Karolina Pliskova,191,2,0,55,50,45,28,59,53,41,28,0.6458333333333334,0.5384615384615384,0.3655913978494624,-4,-3,0,0.9322033898305084,2.2222222222222223,78,100,-0.4467005076142132,-4.0,0.0,54.19796954314721,2,55,1,45.0,0.0,45.0,0.9322033898305084,0
192,Tsvetana Pironkova,Samantha Stosur,192,2,1,59,20,41,10,57,15,43,4,0.5625,0.19230769230769232,0.3870967741935484,2,5,6,1.0350877192982457,2.4390243902439024,30,100,-0.4467005076142132,2.0,6.0,54.19796954314721,2,59,1,41.0,1.0,41.0,1.0350877192982457,1
193,Ana Ivanovic,Annika Beck,193,2,0,75,13,25,3,54,16,46,13,0.22916666666666666,0.057692307692307696,0.41935483870967744,21,-3,-10,1.3888888888888888,4.0,16,100,-0.4467005076142132,21.0,-10.0,54.19796954314721,2,75,1,29.5,0.0,25.0,1.3888888888888888,0
194,Madison Keys,Jie Zheng,194,2,1,76,40,24,14,63,39,37,18,0.20833333333333334,0.2692307692307692,0.3225806451612903,13,1,-4,1.2063492063492063,4.166666666666667,54,100,-0.4467005076142132,13.0,-4.0,54.19796954314721,2,76,1,24.0,1.0,24.0,1.2063492063492063,1
195,Kirsten Flipkens,Casey Dellacqua,195,2,1,73,22,27,6,48,15,52,10,0.2708333333333333,0.11538461538461539,0.4838709677419355,25,7,-4,1.5208333333333333,3.7037037037037037,28,100,-0.4467005076142132,25.0,-4.0,54.19796954314721,2,73,1,27.0,1.0,27.0,1.5208333333333333,1
196,Virginie Razzano,Eugenie Bouchard,196,2,1,50,26,50,17,75,32,25,6,0.75,0.3269230769230769,0.1935483870967742,-25,-6,11,0.6666666666666666,2.0,43,100,-0.4467005076142132,-25.0,11.0,54.19796954314721,2,50,1,46.5,1.0,50.0,0.6666666666666666,0
197,Julia Goerges,Lauren Davis,197,2,1,69,51,31,15,71,45,29,11,0.3541666666666667,0.28846153846153844,0.23655913978494625,-2,6,4,0.971830985915493,3.225806451612903,66,100,-0.4467005076142132,-2.0,4.0,54.19796954314721,2,69,1,31.0,1.0,31.0,0.971830985915493,1
198,Belinda Bencic,Na Li,198,2,1,60,27,40,12,54,21,46,8,0.5416666666666666,0.23076923076923078,0.41935483870967744,6,6,4,1.1111111111111112,2.5,39,100,-0.4467005076142132,6.0,4.0,54.19796954314721,2,60,1,38.5,1.0,40.0,1.1111111111111112,1
199,Lucie Safarova,Lucie Hradecka,199,2,0,44,33,56,26,62,47,38,20,0.875,0.5,0.3333333333333333,-18,-14,6,0.7096774193548387,1.7857142857142858,59,100,-0.4467005076142132,-18.0,6.0,54.19796954314721,2,44,1,56.0,0.0,56.0,0.7096774193548387,0
200,Irina Falconi,Ekaterina Makarova,200,2,1,56,26,44,14,74,22,26,10,0.625,0.2692307692307692,0.20430107526881722,-18,4,4,0.7567567567567568,2.272727272727273,40,100,-0.4467005076142132,-18.0,4.0,54.19796954314721,2,56,1,44.0,1.0,44.0,0.7567567567567568,1
201,Sabine Lisicki,Monica Niculescu,201,2,1,66,35,34,9,53,23,47,14,0.4166666666666667,0.17307692307692307,0.43010752688172044,13,12,-5,1.2452830188679245,2.9411764705882355,44,100,-0.4467005076142132,13.0,-5.0,54.19796954314721,2,66,1,34.0,1.0,34.0,1.2452830188679245,1
202,Alla Kudryavtseva,Angelique Kerber,202,2,1,59,24,41,11,63,25,37,8,0.5625,0.21153846153846154,0.3225806451612903,-4,-1,3,0.9365079365079365,2.4390243902439024,35,100,-0.4467005076142132,-4.0,3.0,54.19796954314721,2,59,1,41.0,1.0,41.0,0.9365079365079365,0
203,Alison Riske,Yanina Wickmayer,203,2,0,63,13,37,6,78,27,22,6,0.4791666666666667,0.11538461538461539,0.16129032258064516,-15,-14,0,0.8076923076923077,2.7027027027027026,19,100,-0.4467005076142132,-15.0,0.0,54.19796954314721,2,63,1,37.0,0.0,37.0,0.8076923076923077,0
204,Monica Puig,Flavia Pennetta,204,2,1,45,22,55,18,45,21,55,16,0.8541666666666666,0.34615384615384615,0.5161290322580645,0,1,2,1.0,1.8181818181818181,40,100,-0.4467005076142132,0.0,2.0,54.19796954314721,2,45,1,55.0,1.0,55.0,1.0,1
205,Luksika Kumkhum,Mona Barthel,205,2,1,63,44,37,18,58,38,42,13,0.4791666666666667,0.34615384615384615,0.3763440860215054,5,6,5,1.0862068965517242,2.7027027027027026,62,100,-0.4467005076142132,5.0,5.0,54.19796954314721,2,63,1,37.0,1.0,37.0,1.0862068965517242,1
206,Ayumi Morita,Jelena Jankovic,206,2,1,59,19,41,7,57,8,43,5,0.5625,0.1346153846153846,0.3870967741935484,2,11,2,1.0350877192982457,2.4390243902439024,26,100,-0.4467005076142132,2.0,2.0,54.19796954314721,2,59,1,40.5,1.0,41.0,1.0350877192982457,1
207,Magdalena Rybarikova,Kurumi Nara,207,2,1,66,26,34,15,52,16,48,8,0.4166666666666667,0.28846153846153844,0.44086021505376344,14,10,7,1.2692307692307692,2.9411764705882355,41,100,-0.4467005076142132,14.0,7.0,54.19796954314721,2,66,1,34.0,1.0,34.0,1.2692307692307692,1
208,Zarina Diyas,Marina Erakovic,208,2,0,50,15,50,8,70,27,30,10,0.75,0.15384615384615385,0.24731182795698925,-20,-12,-2,0.7142857142857143,2.0,23,100,-0.4467005076142132,-20.0,-2.0,54.19796954314721,2,50,1,50.0,0.0,50.0,0.7142857142857143,0
209,Simona Halep,Varvara Lepchenko,209,2,0,63,34,37,10,58,29,42,16,0.4791666666666667,0.19230769230769232,0.3763440860215054,5,5,-6,1.0862068965517242,2.7027027027027026,44,100,-0.4467005076142132,5.0,-6.0,54.19796954314721,2,63,1,38.0,0.0,37.0,1.0862068965517242,1
210,Galina Voskoboeva,Carla Suarez Navarro,210,2,1,73,57,27,17,55,40,45,23,0.2708333333333333,0.3269230769230769,0.40860215053763443,18,17,-6,1.3272727272727274,3.7037037037037037,74,100,-0.4467005076142132,18.0,-6.0,54.19796954314721,2,73,1,27.0,1.0,27.0,1.3272727272727274,1
211,Dominika Cibulkova,Stefanie Voegele,211,2,0,42,11,58,1,68,21,32,8,0.9166666666666666,0.019230769230769232,0.26881720430107525,-26,-10,-7,0.6176470588235294,1.7241379310344827,12,100,-0.4467005076142132,-26.0,-7.0,54.19796954314721,2,42,1,58.0,0.0,58.0,0.6176470588235294,0
212,Camila Giorgi,Alize Cornet,212,2,1,59,39,41,17,56,31,44,20,0.5625,0.3269230769230769,0.3978494623655914,3,8,-3,1.0535714285714286,2.4390243902439024,56,100,-0.4467005076142132,3.0,-3.0,54.19796954314721,2,59,1,33.5,1.0,41.0,1.0535714285714286,1
213,Maria Sharapova,Karin Knapp,213,2,1,53,40,47,23,60,44,40,23,0.6875,0.4423076923076923,0.3548387096774194,-7,-4,0,0.8833333333333333,2.127659574468085,63,100,-0.4467005076142132,-7.0,0.0,54.19796954314721,2,53,1,47.0,1.0,47.0,0.8833333333333333,0
214,Olga Govortsova,Agnieszka Radwanska,214,2,1,66,28,34,8,70,20,30,6,0.4166666666666667,0.15384615384615385,0.24731182795698925,-4,8,2,0.9428571428571428,2.9411764705882355,36,100,-0.4467005076142132,-4.0,2.0,54.19796954314721,2,66,1,34.5,1.0,34.0,0.9428571428571428,1
215,Anastasia Pavlyuchenkova,Mandy Minella,215,2,0,55,21,45,11,67,24,33,8,0.6458333333333334,0.21153846153846154,0.27956989247311825,-12,-3,3,0.8208955223880597,2.2222222222222223,32,100,-0.4467005076142132,-12.0,3.0,54.19796954314721,2,55,1,45.0,0.0,45.0,0.8208955223880597,0
216,Anna Schmiedlova,Garbine Muguruza,216,2,1,56,23,44,11,59,15,41,7,0.625,0.21153846153846154,0.3655913978494624,-3,8,4,0.9491525423728814,2.272727272727273,34,100,-0.4467005076142132,-3.0,4.0,54.19796954314721,2,56,1,44.0,1.0,44.0,0.9491525423728814,1
217,Caroline Wozniacki,Christina McHale,217,2,0,53,22,47,12,74,30,26,8,0.6875,0.23076923076923078,0.20430107526881722,-21,-8,4,0.7162162162162162,2.127659574468085,34,100,-0.4467005076142132,-21.0,4.0,54.19796954314721,2,53,1,47.0,0.0,47.0,0.7162162162162162,0
218,Ajla Tomljanovic,Sloane Stephens,218,2,1,71,39,29,14,54,35,46,22,0.3125,0.2692307692307692,0.41935483870967744,17,4,-8,1.3148148148148149,3.4482758620689653,53,100,-0.4467005076142132,17.0,-8.0,54.19796954314721,2,71,1,29.0,1.0,29.0,1.3148148148148149,1
219,Elina Svitolina,Olivia Rogowska,219,2,0,61,26,39,14,53,26,47,15,0.5208333333333334,0.2692307692307692,0.43010752688172044,8,0,-1,1.150943396226415,2.5641025641025643,40,100,-0.4467005076142132,8.0,-1.0,54.19796954314721,2,61,1,39.0,0.0,39.0,1.150943396226415,0
220,Yvonne Meusburger,Bojana Jovanovski,220,2,0,69,30,31,14,67,38,33,5,0.3541666666666667,0.2692307692307692,0.27956989247311825,2,-8,9,1.0298507462686568,3.225806451612903,44,100,-0.4467005076142132,2.0,9.0,54.19796954314721,2,69,1,31.0,0.0,31.0,1.0298507462686568,0
221,Victoria Azarenka,Barbora Zahlavova Strycova,221,2,0,55,13,45,9,85,34,15,6,0.6458333333333334,0.17307692307692307,0.08602150537634409,-30,-21,3,0.6470588235294118,2.2222222222222223,22,100,-0.4467005076142132,-30.0,3.0,54.19796954314721,2,55,1,45.0,0.0,45.0,0.6470588235294118,0
222,Daniela Hantuchova,Serena Williams,222,3,1,48,20,52,15,54,15,46,12,0.7916666666666666,0.28846153846153844,0.41935483870967744,-6,5,3,0.8888888888888888,1.9230769230769231,35,100,0.037383177570093455,-6.0,3.0,50.467289719626166,3,48,1,42.5,1.0,52.0,0.8888888888888888,1
223,Ana Ivanovic,Samantha Stosur,223,3,0,68,42,32,22,58,47,42,23,0.375,0.4230769230769231,0.3763440860215054,10,-5,-1,1.1724137931034482,3.125,64,100,0.037383177570093455,10.0,-1.0,50.467289719626166,3,68,1,32.0,0.0,32.0,1.1724137931034482,0
224,Casey Dellacqua,Jie Zheng,224,3,0,64,18,36,11,58,20,42,14,0.4583333333333333,0.21153846153846154,0.3763440860215054,6,-2,-3,1.103448275862069,2.7777777777777777,29,100,0.037383177570093455,6.0,-3.0,50.467289719626166,3,64,1,27.5,0.0,36.0,1.103448275862069,0
225,Lauren Davis,Eugenie Bouchard,225,3,1,61,23,39,10,77,24,23,3,0.5208333333333334,0.19230769230769232,0.17204301075268819,-16,-1,7,0.7922077922077922,2.5641025641025643,33,100,0.037383177570093455,-16.0,7.0,50.467289719626166,3,61,1,39.0,1.0,39.0,0.7922077922077922,0
226,Lucie Safarova,Na Li,226,3,1,60,43,40,18,59,33,41,17,0.5416666666666666,0.34615384615384615,0.3655913978494624,1,10,1,1.0169491525423728,2.5,61,100,0.037383177570093455,1.0,1.0,50.467289719626166,3,60,1,40.0,1.0,40.0,1.0169491525423728,1
227,Monica Niculescu,Ekaterina Makarova,227,3,1,56,17,44,13,70,23,30,8,0.625,0.25,0.24731182795698925,-14,-6,5,0.8,2.272727272727273,30,100,0.037383177570093455,-14.0,5.0,50.467289719626166,3,56,1,44.0,1.0,44.0,0.8,0
228,Alison Riske,Angelique Kerber,228,3,1,63,21,37,6,62,16,38,8,0.4791666666666667,0.11538461538461539,0.3333333333333333,1,5,-2,1.0161290322580645,2.7027027027027026,27,100,0.037383177570093455,1.0,-2.0,50.467289719626166,3,63,1,37.0,1.0,37.0,1.0161290322580645,1
229,Mona Barthel,Flavia Pennetta,229,3,1,44,17,56,15,60,22,40,13,0.875,0.28846153846153844,0.3548387096774194,-16,-5,2,0.7333333333333333,1.7857142857142858,32,100,0.037383177570093455,-16.0,2.0,50.467289719626166,3,44,1,56.0,1.0,56.0,0.7333333333333333,0
230,Kurumi Nara,Jelena Jankovic,230,3,1,62,23,38,13,86,25,14,5,0.5,0.25,0.07526881720430108,-24,-2,8,0.7209302325581395,2.6315789473684212,36,100,0.037383177570093455,-24.0,8.0,50.467289719626166,3,62,1,32.5,1.0,38.0,0.7209302325581395,0
231,Simona Halep,Zarina Diyas,231,3,0,61,16,39,7,52,18,48,13,0.5208333333333334,0.1346153846153846,0.44086021505376344,9,-2,-6,1.1730769230769231,2.5641025641025643,23,100,0.037383177570093455,9.0,-6.0,50.467289719626166,3,61,1,39.0,0.0,39.0,1.1730769230769231,0
232,Dominika Cibulkova,Carla Suarez Navarro,232,3,0,65,12,35,4,69,21,31,8,0.4375,0.07692307692307693,0.25806451612903225,-4,-9,-4,0.9420289855072463,2.857142857142857,16,100,0.037383177570093455,-4.0,-4.0,50.467289719626166,3,65,1,35.0,0.0,35.0,0.9420289855072463,0
233,Maria Sharapova,Alize Cornet,233,3,0,65,24,35,9,50,23,50,16,0.4375,0.17307692307692307,0.46236559139784944,15,1,-7,1.3,2.857142857142857,33,100,0.037383177570093455,15.0,-7.0,50.467289719626166,3,65,1,35.0,0.0,35.0,1.3,1
234,Anastasia Pavlyuchenkova,Agnieszka Radwanska,234,3,1,65,36,35,16,59,29,41,17,0.4375,0.3076923076923077,0.3655913978494624,6,7,-1,1.1016949152542372,2.857142857142857,52,100,0.037383177570093455,6.0,-1.0,50.467289719626166,3,65,1,37.0,1.0,35.0,1.1016949152542372,1
235,Caroline Wozniacki,Garbine Muguruza,235,3,1,64,37,36,16,67,39,33,12,0.4583333333333333,0.3076923076923077,0.27956989247311825,-3,-2,4,0.9552238805970149,2.7777777777777777,53,100,0.037383177570093455,-3.0,4.0,50.467289719626166,3,64,1,36.0,1.0,36.0,0.9552238805970149,0
236,Elina Svitolina,Sloane Stephens,236,3,1,69,31,31,10,57,23,43,15,0.3541666666666667,0.19230769230769232,0.3870967741935484,12,8,-5,1.2105263157894737,3.225806451612903,41,100,0.037383177570093455,12.0,-5.0,50.467289719626166,3,69,1,31.0,1.0,31.0,1.2105263157894737,1
237,Victoria Azarenka,Yvonne Meusburger,237,3,0,70,8,30,4,74,20,26,5,0.3333333333333333,0.07692307692307693,0.20430107526881722,-4,-12,-1,0.9459459459459459,3.3333333333333335,12,100,0.037383177570093455,-4.0,-1.0,50.467289719626166,3,70,1,30.0,0.0,30.0,0.9459459459459459,0
238,Ana Ivanovic,Serena Williams,238,4,0,66,43,34,13,53,31,47,21,0.4166666666666667,0.25,0.43010752688172044,13,12,-8,1.2452830188679245,2.9411764705882355,56,100,0.38181818181818183,13.0,-8.0,55.54545454545455,4,66,1,36.0,0.0,34.0,1.2452830188679245,1
239,Eugenie Bouchard,Casey Dellacqua,239,4,0,61,33,39,14,65,37,35,16,0.5208333333333334,0.2692307692307692,0.3010752688172043,-4,-4,-2,0.9384615384615385,2.5641025641025643,47,100,0.38181818181818183,-4.0,-2.0,55.54545454545455,4,61,1,39.0,0.0,39.0,0.9384615384615385,0
240,Ekaterina Makarova,Na Li,240,4,1,80,26,20,4,64,14,36,3,0.125,0.07692307692307693,0.3118279569892473,16,12,1,1.25,5.0,30,100,0.38181818181818183,16.0,1.0,55.54545454545455,4,80,1,20.0,1.0,20.0,1.25,1
241,Flavia Pennetta,Angelique Kerber,241,4,0,64,35,36,10,60,33,40,12,0.4583333333333333,0.19230769230769232,0.3548387096774194,4,2,-2,1.0666666666666667,2.7777777777777777,45,100,0.38181818181818183,4.0,-2.0,55.54545454545455,4,64,1,36.0,0.0,36.0,1.0666666666666667,1
242,Simona Halep,Jelena Jankovic,242,4,0,67,32,33,11,64,26,36,14,0.3958333333333333,0.21153846153846154,0.3118279569892473,3,6,-3,1.046875,3.0303030303030303,43,100,0.38181818181818183,3.0,-3.0,55.54545454545455,4,67,1,33.0,0.0,33.0,1.046875,1
243,Maria Sharapova,Dominika Cibulkova,243,4,1,69,27,31,13,66,31,34,12,0.3541666666666667,0.25,0.2903225806451613,3,-4,1,1.0454545454545454,3.225806451612903,40,100,0.38181818181818183,3.0,1.0,55.54545454545455,4,69,1,31.0,1.0,31.0,1.0454545454545454,0
244,Garbine Muguruza,Agnieszka Radwanska,244,4,1,73,34,27,11,56,18,44,10,0.2708333333333333,0.21153846153846154,0.3978494623655914,17,16,1,1.3035714285714286,3.7037037037037037,45,100,0.38181818181818183,17.0,1.0,55.54545454545455,4,73,1,35.0,1.0,27.0,1.3035714285714286,1
245,Victoria Azarenka,Sloane Stephens,245,4,0,72,24,28,9,69,32,31,10,0.2916666666666667,0.17307692307692307,0.25806451612903225,3,-8,-1,1.0434782608695652,3.5714285714285716,33,100,0.38181818181818183,3.0,-1.0,55.54545454545455,4,72,1,31.5,0.0,28.0,1.0434782608695652,0
246,Eugenie Bouchard,Ana Ivanovic,246,5,0,56,34,44,23,58,42,42,20,0.625,0.4423076923076923,0.3763440860215054,-2,-8,3,0.9655172413793104,2.272727272727273,57,100,-1.2222222222222223,-2.0,3.0,54.333333333333336,5,56,1,44.0,0.0,44.0,0.9655172413793104,0
247,Flavia Pennetta,Na Li,247,5,1,64,23,36,10,39,12,61,13,0.4583333333333333,0.19230769230769232,0.5806451612903226,25,11,-3,1.641025641025641,2.7777777777777777,33,100,-1.2222222222222223,25.0,-3.0,54.333333333333336,5,64,1,36.0,1.0,36.0,1.641025641025641,1
248,Dominika Cibulkova,Simona Halep,248,5,0,67,13,33,6,77,25,23,5,0.3958333333333333,0.11538461538461539,0.17204301075268819,-10,-12,1,0.8701298701298701,3.0303030303030303,19,100,-1.2222222222222223,-10.0,1.0,54.333333333333336,5,67,1,33.0,0.0,33.0,0.8701298701298701,0
249,Victoria Azarenka,Agnieszka Radwanska,249,5,1,59,33,41,16,60,26,40,19,0.5625,0.3076923076923077,0.3548387096774194,-1,7,-3,0.9833333333333333,2.4390243902439024,49,100,-1.2222222222222223,-1.0,-3.0,54.333333333333336,5,59,1,35.5,1.0,41.0,0.9833333333333333,1
250,Na Li,Eugenie Bouchard,250,6,0,45,13,55,5,61,27,39,11,0.8541666666666666,0.09615384615384616,0.34408602150537637,-16,-14,-6,0.7377049180327869,1.8181818181818181,18,100,-3.2857142857142856,-16.0,-6.0,57.357142857142854,6,45,1,55.0,0.0,55.0,0.7377049180327869,0
251,Agnieszka Radwanska,Dominika Cibulkova,251,6,1,64,22,36,10,68,17,32,2,0.4583333333333333,0.19230769230769232,0.26881720430107525,-4,5,8,0.9411764705882353,2.7777777777777777,32,100,-3.2857142857142856,-4.0,8.0,57.357142857142854,6,64,1,36.0,1.0,36.0,0.9411764705882353,1
252,Dominika Cibulkova,Na Li,252,7,1,60,21,40,15,67,29,33,5,0.5416666666666666,0.28846153846153844,0.27956989247311825,-7,-8,10,0.8955223880597015,2.5,36,100,5.285714285714286,-7.0,10.0,47.857142857142854,7,60,1,40.0,1.0,40.0,0.8955223880597015,0
253,Roger Federer,Pablo Carreno-Busta,253,1,0,62,27,38,11,68,33,32,14,0.5,0.21153846153846154,0.26881720430107525,-6,-6,-3,0.9117647058823529,2.6315789473684212,38,100,0.5652985074626866,-6.0,-3.0,57.115671641791046,1,62,1,38.0,0.0,38.0,0.9117647058823529,0
254,Daniel Munoz-De La Nava,Somdev Devvarman,254,1,1,62,54,38,22,52,35,48,24,0.5,0.4230769230769231,0.44086021505376344,10,19,-2,1.1923076923076923,2.6315789473684212,76,100,0.5652985074626866,10.0,-2.0,57.115671641791046,1,62,1,43.0,1.0,38.0,1.1923076923076923,1
255,Paolo Lorenzi,Tobias Kamke,255,1,1,62,53,38,15,46,42,54,31,0.5,0.28846153846153844,0.5053763440860215,16,11,-16,1.3478260869565217,2.6315789473684212,68,100,0.5652985074626866,16.0,-16.0,57.115671641791046,1,62,1,47.5,1.0,38.0,1.3478260869565217,1
256,Ricardas Berankis,Julien Benneteau,256,1,1,72,87,28,19,53,58,47,38,0.2916666666666667,0.36538461538461536,0.43010752688172044,19,29,-19,1.3584905660377358,3.5714285714285716,106,100,0.5652985074626866,19.0,-19.0,57.115671641791046,1,72,1,39.25,1.0,28.0,1.3584905660377358,1
257,Sam Querrey,Lukas Lacko,257,1,0,52,31,48,22,58,39,42,19,0.7083333333333334,0.4230769230769231,0.3763440860215054,-6,-8,3,0.896551724137931,2.0833333333333335,53,100,0.5652985074626866,-6.0,3.0,57.115671641791046,1,52,1,45.666666666666664,0.0,48.0,0.896551724137931,0
258,Denis Kudla,Jan Hajek,258,1,1,70,58,30,18,68,48,32,17,0.3333333333333333,0.34615384615384615,0.26881720430107525,2,10,1,1.0294117647058822,3.3333333333333335,76,100,0.5652985074626866,2.0,1.0,57.115671641791046,1,70,1,28.5,1.0,30.0,1.0294117647058822,1
259,Pablo Cuevas,Adrian Mannarino,259,1,0,63,71,37,38,59,67,41,27,0.4791666666666667,0.7307692307692307,0.3655913978494624,4,4,11,1.0677966101694916,2.7027027027027026,109,100,0.5652985074626866,4.0,11.0,57.115671641791046,1,63,1,41.0,0.0,37.0,1.0677966101694916,1
260,Lleyton Hewitt,Gilles Simon,260,1,1,59,42,41,25,49,40,51,29,0.5625,0.4807692307692308,0.4731182795698925,10,2,-4,1.2040816326530612,2.4390243902439024,67,100,0.5652985074626866,10.0,-4.0,57.115671641791046,1,59,1,41.0,1.0,41.0,1.2040816326530612,1
261,Marin Cilic,Philipp Petzschner,261,1,0,56,27,44,13,50,26,50,20,0.625,0.25,0.46236559139784944,6,1,-7,1.12,2.272727272727273,40,100,0.5652985074626866,6.0,-7.0,57.115671641791046,1,56,1,44.0,0.0,44.0,1.12,1
262,Nick Kyrgios,Radek Stepanek,262,1,0,63,62,37,29,56,64,44,35,0.4791666666666667,0.5576923076923077,0.3978494623655914,7,-2,-6,1.125,2.7027027027027026,91,100,0.5652985074626866,7.0,-6.0,57.115671641791046,1,63,1,43.0,0.0,37.0,1.125,0
263,James Blake,Viktor Troicki,263,1,1,48,29,52,20,47,22,53,15,0.7916666666666666,0.38461538461538464,0.4946236559139785,1,7,5,1.0212765957446808,1.9230769230769231,49,100,0.5652985074626866,1.0,5.0,57.115671641791046,1,48,1,52.0,1.0,52.0,1.0212765957446808,1
264,Daniel Gimeno-Traver,Juan Monaco,264,1,0,78,85,22,22,52,67,48,47,0.16666666666666666,0.4230769230769231,0.44086021505376344,26,18,-25,1.5,4.545454545454546,107,100,0.5652985074626866,26.0,-25.0,57.115671641791046,1,78,1,23.0,0.0,22.0,1.5,1
265,Jeremy Chardy,Benjamin Becker,265,1,0,66,48,34,13,66,44,34,17,0.4166666666666667,0.25,0.2903225806451613,0,4,-4,1.0,2.9411764705882355,61,100,0.5652985074626866,0.0,-4.0,57.115671641791046,1,66,1,41.0,0.0,34.0,1.0,1
266,Gilles Muller,Roberto Bautista Agut,266,1,1,83,51,17,6,55,36,45,18,0.0625,0.11538461538461539,0.40860215053763443,28,15,-12,1.509090909090909,5.882352941176471,57,100,0.5652985074626866,28.0,-12.0,57.115671641791046,1,83,1,24.5,1.0,17.0,1.509090909090909,1
267,Paul-Henri Mathieu,Jarkko Nieminen,267,1,1,69,84,31,29,54,58,46,36,0.3541666666666667,0.5576923076923077,0.41935483870967744,15,26,-7,1.2777777777777777,3.225806451612903,113,100,0.5652985074626866,15.0,-7.0,57.115671641791046,1,69,1,33.5,1.0,31.0,1.2777777777777777,1
268,Aljaz Bedene,Jo-Wilfried Tsonga,268,1,1,50,32,50,23,62,26,38,12,0.75,0.4423076923076923,0.3333333333333333,-12,6,11,0.8064516129032258,2.0,55,100,0.5652985074626866,-12.0,11.0,57.115671641791046,1,50,1,44.0,1.0,50.0,0.8064516129032258,1
269,David Ferrer,Marinko Matosevic,269,1,0,59,29,41,10,55,33,45,18,0.5625,0.19230769230769232,0.40860215053763443,4,-4,-8,1.0727272727272728,2.4390243902439024,39,100,0.5652985074626866,4.0,-8.0,57.115671641791046,1,59,1,40.0,0.0,41.0,1.0727272727272728,0
270,Albert Montanes,Steve Johnson,270,1,0,55,53,45,32,65,59,35,21,0.6458333333333334,0.6153846153846154,0.3010752688172043,-10,-6,11,0.8461538461538461,2.2222222222222223,85,100,0.5652985074626866,-10.0,11.0,57.115671641791046,1,55,1,46.0,0.0,45.0,0.8461538461538461,0
271,Go Soeda,Joao Sousa,271,1,1,70,40,30,14,58,24,42,10,0.3333333333333333,0.2692307692307692,0.3763440860215054,12,16,4,1.206896551724138,3.3333333333333335,54,100,0.5652985074626866,12.0,4.0,57.115671641791046,1,70,1,36.0,1.0,30.0,1.206896551724138,1
272,Feliciano Lopez,Marcel Granollers,272,1,0,70,55,30,18,58,52,42,33,0.3333333333333333,0.34615384615384615,0.3763440860215054,12,3,-15,1.206896551724138,3.3333333333333335,73,100,0.5652985074626866,12.0,-15.0,57.115671641791046,1,70,1,34.0,0.0,30.0,1.206896551724138,1
273,Kevin Anderson,Illya Marchenko,273,1,0,60,39,40,25,64,50,36,15,0.5416666666666666,0.4807692307692308,0.3118279569892473,-4,-11,10,0.9375,2.5,64,100,0.5652985074626866,-4.0,10.0,57.115671641791046,1,60,1,40.0,0.0,40.0,0.9375,0
274,Evgeny Donskoy,Jan-Lennard Struff,274,1,0,48,47,52,32,59,59,41,25,0.7916666666666666,0.6153846153846154,0.3655913978494624,-11,-12,7,0.8135593220338984,1.9230769230769231,79,100,0.5652985074626866,-11.0,7.0,57.115671641791046,1,48,1,48.5,0.0,52.0,0.8135593220338984,0
275,Michael Llodra,Steve Darcis,275,1,0,71,49,29,23,58,56,42,16,0.3125,0.4423076923076923,0.3763440860215054,13,-7,7,1.2241379310344827,3.4482758620689653,72,100,0.5652985074626866,13.0,7.0,57.115671641791046,1,71,1,29.0,0.0,29.0,1.2241379310344827,0
276,Xavier Malisse,Milos Raonic,276,1,1,73,55,27,14,64,42,36,18,0.2708333333333333,0.2692307692307692,0.3118279569892473,9,13,-4,1.140625,3.7037037037037037,69,100,0.5652985074626866,9.0,-4.0,57.115671641791046,1,73,1,31.5,1.0,27.0,1.140625,1
277,Nicolas Almagro,Andreas Haider-Maurer,277,1,0,65,50,35,20,53,50,47,28,0.4375,0.38461538461538464,0.43010752688172044,12,0,-8,1.2264150943396226,2.857142857142857,70,100,0.5652985074626866,12.0,-8.0,57.115671641791046,1,65,1,37.5,0.0,35.0,1.2264150943396226,0
278,Edouard Roger-Vasselin,Martin Alund,278,1,0,57,31,43,17,63,45,37,22,0.6041666666666666,0.3269230769230769,0.3225806451612903,-6,-14,-5,0.9047619047619048,2.3255813953488373,48,100,0.5652985074626866,-6.0,-5.0,57.115671641791046,1,57,1,43.0,0.0,43.0,0.9047619047619048,0
279,James Duckworth,Blaz Kavcic,279,1,1,63,33,37,17,46,19,54,11,0.4791666666666667,0.3269230769230769,0.5053763440860215,17,14,6,1.3695652173913044,2.7027027027027026,50,100,0.5652985074626866,17.0,6.0,57.115671641791046,1,63,1,37.0,1.0,37.0,1.3695652173913044,1
280,Leonardo Mayer,Andreas Seppi,280,1,1,67,73,33,32,64,68,36,28,0.3958333333333333,0.6153846153846154,0.3118279569892473,3,5,4,1.046875,3.0303030303030303,105,100,0.5652985074626866,3.0,4.0,57.115671641791046,1,67,1,40.4,1.0,33.0,1.046875,1
281,Tommy Robredo,Jurgen Zopp,281,1,0,68,35,32,9,65,37,35,12,0.375,0.17307692307692307,0.3010752688172043,3,-2,-3,1.0461538461538462,3.125,44,100,0.5652985074626866,3.0,-3.0,57.115671641791046,1,68,1,40.5,0.0,32.0,1.0461538461538462,0
282,Jurgen Melzer,Igor Sijsling,282,1,1,64,41,36,18,72,37,28,6,0.4583333333333333,0.34615384615384615,0.22580645161290322,-8,4,12,0.8888888888888888,2.7777777777777777,59,100,0.5652985074626866,-8.0,12.0,57.115671641791046,1,64,1,40.5,1.0,36.0,0.8888888888888888,1
283,Rogerio Dutra Silva,Ernests Gulbis,283,1,1,53,36,47,23,65,31,35,13,0.6875,0.4423076923076923,0.3010752688172043,-12,5,10,0.8153846153846154,2.127659574468085,59,100,0.5652985074626866,-12.0,10.0,57.115671641791046,1,53,1,44.5,1.0,47.0,0.8153846153846154,1
284,Gael Monfils,Tomas Berdych,284,1,0,66,91,34,33,72,104,28,27,0.4166666666666667,0.6346153846153846,0.22580645161290322,-6,-13,6,0.9166666666666666,2.9411764705882355,124,100,0.5652985074626866,-6.0,6.0,57.115671641791046,1,66,1,34.0,0.0,34.0,0.9166666666666666,0
285,Richard Gasquet,Sergiy Stakhovsky,285,1,0,55,22,45,17,67,36,33,16,0.6458333333333334,0.3269230769230769,0.27956989247311825,-12,-14,1,0.8208955223880597,2.2222222222222223,39,100,0.5652985074626866,-12.0,1.0,57.115671641791046,1,55,1,46.0,0.0,45.0,0.8208955223880597,0
286,Rhyne Williams,Michal Przysiezny,286,1,1,67,75,33,27,67,66,33,21,0.3958333333333333,0.5192307692307693,0.27956989247311825,0,9,6,1.0,3.0303030303030303,102,100,0.5652985074626866,0.0,6.0,57.115671641791046,1,67,1,32.0,1.0,33.0,1.0,1
287,Nikolay Davydenko,Florent Serra,287,1,0,64,35,36,13,67,50,33,16,0.4583333333333333,0.25,0.27956989247311825,-3,-15,-3,0.9552238805970149,2.7777777777777777,48,100,0.5652985074626866,-3.0,-3.0,57.115671641791046,1,64,1,36.0,0.0,36.0,0.9552238805970149,0
288,Denis Istomin,Florian Mayer,288,1,0,59,40,41,15,69,44,31,13,0.5625,0.28846153846153844,0.25806451612903225,-10,-4,2,0.855072463768116,2.4390243902439024,55,100,0.5652985074626866,-10.0,2.0,57.115671641791046,1,59,1,39.333333333333336,0.0,41.0,0.855072463768116,0
289,Jerzy Janowicz,Albert Ramos,289,1,0,61,41,39,25,63,49,37,26,0.5208333333333334,0.4807692307692308,0.3225806451612903,-2,-8,-1,0.9682539682539683,2.5641025641025643,66,100,0.5652985074626866,-2.0,-1.0,57.115671641791046,1,61,1,41.0,0.0,39.0,0.9682539682539683,0
290,Robin Haase,Kenny De Schepper,290,1,0,64,61,36,21,65,59,35,25,0.4583333333333333,0.40384615384615385,0.3010752688172043,-1,2,-4,0.9846153846153847,2.7777777777777777,82,100,0.5652985074626866,-1.0,-4.0,57.115671641791046,1,64,1,38.5,0.0,36.0,0.9846153846153847,1
291,Horacio Zeballos,Vasek Pospisil,291,1,0,56,67,44,34,68,71,32,18,0.625,0.6538461538461539,0.26881720430107525,-12,-4,16,0.8235294117647058,2.272727272727273,101,100,0.5652985074626866,-12.0,16.0,57.115671641791046,1,56,1,44.0,0.0,44.0,0.8235294117647058,0
292,Thiemo De Bakker,Stanislas Wawrinka,292,1,1,69,74,31,24,69,70,31,25,0.3541666666666667,0.46153846153846156,0.25806451612903225,0,4,-1,1.0,3.225806451612903,98,100,0.5652985074626866,0.0,-1.0,57.115671641791046,1,69,1,41.166666666666664,1.0,31.0,1.0,1
293,Kei Nishikori,Jesse Levine,293,1,0,52,16,48,9,51,27,49,19,0.7083333333333334,0.17307692307692307,0.45161290322580644,1,-11,-10,1.0196078431372548,2.0833333333333335,25,100,0.5652985074626866,1.0,-10.0,57.115671641791046,1,52,1,48.0,0.0,48.0,1.0196078431372548,0
294,Santiago Giraldo,Grega Zemlja,294,1,1,52,32,48,21,64,30,36,12,0.7083333333333334,0.40384615384615385,0.3118279569892473,-12,2,9,0.8125,2.0833333333333335,53,100,0.5652985074626866,-12.0,9.0,57.115671641791046,1,52,1,48.0,1.0,48.0,0.8125,1
295,Maxime Teixeira,Lukasz Kubot,295,1,1,64,30,36,12,64,37,36,12,0.4583333333333333,0.23076923076923078,0.3118279569892473,0,-7,0,1.0,2.7777777777777777,42,100,0.5652985074626866,0.0,0.0,57.115671641791046,1,64,1,49.0,1.0,36.0,1.0,0
296,Marcos Baghdatis,Benoit Paire,296,1,1,46,40,54,29,53,34,47,25,0.8333333333333334,0.5576923076923077,0.43010752688172044,-7,6,4,0.8679245283018868,1.8518518518518519,69,100,0.5652985074626866,-7.0,4.0,57.115671641791046,1,46,1,48.666666666666664,1.0,54.0,0.8679245283018868,1
297,Fabio Fognini,Andreas Beck,297,1,0,55,37,45,25,64,50,36,27,0.6458333333333334,0.4807692307692308,0.3118279569892473,-9,-13,-2,0.859375,2.2222222222222223,62,100,0.5652985074626866,-9.0,-2.0,57.115671641791046,1,55,1,45.0,0.0,45.0,0.859375,0
298,Lukas Rosol,Pere Riba,298,1,0,60,38,40,14,62,41,38,23,0.5416666666666666,0.2692307692307692,0.3333333333333333,-2,-3,-9,0.967741935483871,2.5,52,100,0.5652985074626866,-2.0,-9.0,57.115671641791046,1,60,1,40.0,0.0,40.0,0.967741935483871,0
299,Michael Russell,Martin Klizan,299,1,1,49,29,51,22,69,35,31,9,0.7708333333333334,0.4230769230769231,0.25806451612903225,-20,-6,13,0.7101449275362319,1.9607843137254901,51,100,0.5652985074626866,-20.0,13.0,57.115671641791046,1,49,1,48.5,1.0,51.0,0.7101449275362319,0
300,Daniel Brands,Rafael Nadal,300,1,1,84,74,16,12,74,66,26,22,0.041666666666666664,0.23076923076923078,0.20430107526881722,10,8,-10,1.135135135135135,6.25,86,100,0.5652985074626866,10.0,-10.0,57.115671641791046,1,84,1,27.0,1.0,16.0,1.135135135135135,1
301,Marc Gicquel,Fernando Verdasco,301,1,1,64,37,36,11,53,23,47,13,0.4583333333333333,0.21153846153846154,0.43010752688172044,11,14,-2,1.2075471698113207,2.7777777777777777,48,100,0.5652985074626866,11.0,-2.0,57.115671641791046,1,64,1,38.666666666666664,1.0,36.0,1.2075471698113207,1
302,Julian Reister,Federico Delbonis,302,1,1,55,52,45,27,72,47,28,15,0.6458333333333334,0.5192307692307693,0.22580645161290322,-17,5,12,0.7638888888888888,2.2222222222222223,79,100,0.5652985074626866,-17.0,12.0,57.115671641791046,1,55,1,45.0,1.0,45.0,0.7638888888888888,1
303,Pablo Andujar,Mikhail Youzhny,303,1,1,65,70,35,20,56,49,44,27,0.4375,0.38461538461538464,0.3978494623655914,9,21,-7,1.1607142857142858,2.857142857142857,90,100,0.5652985074626866,9.0,-7.0,57.115671641791046,1,65,1,35.666666666666664,1.0,35.0,1.1607142857142858,1
304,John Isner,Carlos Berlocq,304,1,0,73,45,27,10,63,45,37,16,0.2708333333333333,0.19230769230769232,0.3225806451612903,10,0,-6,1.1587301587301588,3.7037037037037037,55,100,0.5652985074626866,10.0,-6.0,57.115671641791046,1,73,1,35.0,0.0,27.0,1.1587301587301588,0
305,Ryan Harrison,Andrey Kuznetsov,305,1,0,71,48,29,11,56,46,44,26,0.3125,0.21153846153846154,0.3978494623655914,15,2,-15,1.2678571428571428,3.4482758620689653,59,100,0.5652985074626866,15.0,-15.0,57.115671641791046,1,71,1,38.0,0.0,29.0,1.2678571428571428,1
306,Guillermo Garcia-Lopez,Jack Sock,306,1,1,56,32,44,23,63,30,37,11,0.625,0.4423076923076923,0.3225806451612903,-7,2,12,0.8888888888888888,2.272727272727273,55,100,0.5652985074626866,-7.0,12.0,57.115671641791046,1,56,1,49.0,1.0,44.0,0.8888888888888888,1
307,Guillaume Rufin,Tommy Haas,307,1,1,65,48,35,13,61,32,39,21,0.4375,0.25,0.34408602150537637,4,16,-8,1.0655737704918034,2.857142857142857,61,100,0.5652985074626866,4.0,-8.0,57.115671641791046,1,65,1,41.5,1.0,35.0,1.0655737704918034,1
308,Philipp Kohlschreiber,Jiri Vesely,308,1,0,61,59,39,25,62,61,38,21,0.5208333333333334,0.4807692307692308,0.3333333333333333,-1,-2,4,0.9838709677419355,2.5641025641025643,84,100,0.5652985074626866,-1.0,4.0,57.115671641791046,1,61,1,42.0,0.0,39.0,0.9838709677419355,0
309,Yen-Hsun Lu,Simone Bolelli,309,1,0,63,33,37,12,77,32,23,9,0.4791666666666667,0.23076923076923078,0.17204301075268819,-14,1,3,0.8181818181818182,2.7027027027027026,45,100,0.5652985074626866,-14.0,3.0,57.115671641791046,1,63,1,37.0,0.0,37.0,0.8181818181818182,1
310,Victor Hanescu,Bernard Tomic,310,1,0,63,38,37,17,71,51,29,19,0.4791666666666667,0.3269230769230769,0.23655913978494625,-8,-13,-2,0.8873239436619719,2.7027027027027026,55,100,0.5652985074626866,-8.0,-2.0,57.115671641791046,1,63,1,37.5,0.0,37.0,0.8873239436619719,0
311,Dmitry Tursunov,Alexandr Dolgopolov,311,1,0,55,51,45,22,51,47,49,28,0.6458333333333334,0.4230769230769231,0.45161290322580644,4,4,-6,1.0784313725490196,2.2222222222222223,73,100,0.5652985074626866,4.0,-6.0,57.115671641791046,1,55,1,46.0,0.0,45.0,1.0784313725490196,1
312,Grigor Dimitrov,Alejandro Falla,312,1,0,54,10,46,7,59,20,41,10,0.6666666666666666,0.1346153846153846,0.3655913978494624,-5,-10,-3,0.9152542372881356,2.1739130434782608,17,100,0.5652985074626866,-5.0,-3.0,57.115671641791046,1,54,1,43.0,0.0,46.0,0.9152542372881356,0
313,Lucas Pouille,Alex Kuznetsov,313,1,0,63,33,37,13,48,36,52,33,0.4791666666666667,0.25,0.4838709677419355,15,-3,-20,1.3125,2.7027027027027026,46,100,0.5652985074626866,15.0,-20.0,57.115671641791046,1,63,1,37.0,0.0,37.0,1.3125,0
314,Guido Pella,Ivan Dodig,314,1,0,56,80,44,37,61,71,39,35,0.625,0.7115384615384616,0.34408602150537637,-5,9,2,0.9180327868852459,2.272727272727273,117,100,0.5652985074626866,-5.0,2.0,57.115671641791046,1,56,1,42.0,0.0,44.0,0.9180327868852459,1
315,David Goffin,Novak Djokovic,315,1,1,69,53,31,20,61,46,39,25,0.3541666666666667,0.38461538461538464,0.34408602150537637,8,7,-5,1.1311475409836065,3.225806451612903,73,100,0.5652985074626866,8.0,-5.0,57.115671641791046,1,69,1,31.142857142857142,1.0,31.0,1.1311475409836065,1
316,Roger Federer,Somdev Devvarman,316,2,0,61,19,39,16,62,30,38,18,0.5208333333333334,0.3076923076923077,0.3333333333333333,-1,-11,-2,0.9838709677419355,2.5641025641025643,35,100,-0.4467005076142132,-1.0,-2.0,54.19796954314721,2,61,1,39.0,0.0,39.0,0.9838709677419355,0
317,Tobias Kamke,Julien Benneteau,317,2,1,72,83,28,23,65,75,35,37,0.2916666666666667,0.4423076923076923,0.3010752688172043,7,8,-14,1.1076923076923078,3.5714285714285716,106,100,-0.4467005076142132,7.0,-14.0,54.19796954314721,2,72,1,28.0,1.0,28.0,1.1076923076923078,1
318,Sam Querrey,Jan Hajek,318,2,0,66,36,34,16,62,45,38,14,0.4166666666666667,0.3076923076923077,0.3333333333333333,4,-9,2,1.064516129032258,2.9411764705882355,52,100,-0.4467005076142132,4.0,2.0,54.19796954314721,2,66,1,34.0,0.0,34.0,1.064516129032258,0
319,Pablo Cuevas,Gilles Simon,319,2,1,57,41,43,26,56,37,44,19,0.6041666666666666,0.5,0.3978494623655914,1,4,7,1.0178571428571428,2.3255813953488373,67,100,-0.4467005076142132,1.0,7.0,54.19796954314721,2,57,1,43.0,1.0,43.0,1.0178571428571428,1
320,Marin Cilic,Nick Kyrgios,320,2,0,64,33,36,10,51,32,49,23,0.4583333333333333,0.19230769230769232,0.45161290322580644,13,1,-13,1.2549019607843137,2.7777777777777777,43,100,-0.4467005076142132,13.0,-13.0,54.19796954314721,2,64,1,36.0,0.0,36.0,1.2549019607843137,1
321,Viktor Troicki,Daniel Gimeno-Traver,321,2,0,78,84,22,15,56,61,44,35,0.16666666666666666,0.28846153846153844,0.3978494623655914,22,23,-20,1.3928571428571428,4.545454545454546,99,100,-0.4467005076142132,22.0,-20.0,54.19796954314721,2,78,1,22.0,0.0,22.0,1.3928571428571428,1
322,Jeremy Chardy,Roberto Bautista Agut,322,2,0,79,42,21,8,64,50,36,17,0.14583333333333334,0.15384615384615385,0.3118279569892473,15,-8,-9,1.234375,4.761904761904762,50,100,-0.4467005076142132,15.0,-9.0,54.19796954314721,2,79,1,26.0,0.0,21.0,1.234375,0
323,Jarkko Nieminen,Jo-Wilfried Tsonga,323,2,1,65,44,35,19,61,41,39,25,0.4375,0.36538461538461536,0.34408602150537637,4,3,-6,1.0655737704918034,2.857142857142857,63,100,-0.4467005076142132,4.0,-6.0,54.19796954314721,2,65,1,35.5,1.0,35.0,1.0655737704918034,1
324,David Ferrer,Albert Montanes,324,2,0,67,28,33,9,60,31,40,15,0.3958333333333333,0.17307692307692307,0.3548387096774194,7,-3,-6,1.1166666666666667,3.0303030303030303,37,100,-0.4467005076142132,7.0,-6.0,54.19796954314721,2,67,1,33.0,0.0,33.0,1.1166666666666667,0
325,Joao Sousa,Feliciano Lopez,325,2,1,64,56,36,23,66,58,34,24,0.4583333333333333,0.4423076923076923,0.2903225806451613,-2,-2,-1,0.9696969696969697,2.7777777777777777,79,100,-0.4467005076142132,-2.0,-1.0,54.19796954314721,2,64,1,36.0,1.0,36.0,0.9696969696969697,0
326,Kevin Anderson,Evgeny Donskoy,326,2,0,67,62,33,21,68,69,32,26,0.3958333333333333,0.40384615384615385,0.26881720430107525,-1,-7,-5,0.9852941176470589,3.0303030303030303,83,100,-0.4467005076142132,-1.0,-5.0,54.19796954314721,2,67,1,33.0,0.0,33.0,0.9852941176470589,0
327,Michael Llodra,Milos Raonic,327,2,1,63,62,37,25,61,59,39,32,0.4791666666666667,0.4807692307692308,0.34408602150537637,2,3,-7,1.0327868852459017,2.7027027027027026,87,100,-0.4467005076142132,2.0,-7.0,54.19796954314721,2,63,1,36.5,1.0,37.0,1.0327868852459017,1
328,Nicolas Almagro,Edouard Roger-Vasselin,328,2,0,57,30,43,16,46,36,54,30,0.6041666666666666,0.3076923076923077,0.5053763440860215,11,-6,-14,1.2391304347826086,2.3255813953488373,46,100,-0.4467005076142132,11.0,-14.0,54.19796954314721,2,57,1,43.0,0.0,43.0,1.2391304347826086,0
329,Blaz Kavcic,Andreas Seppi,329,2,1,57,67,43,41,63,64,37,37,0.6041666666666666,0.7884615384615384,0.3225806451612903,-6,3,4,0.9047619047619048,2.3255813953488373,108,100,-0.4467005076142132,-6.0,4.0,54.19796954314721,2,57,1,43.0,1.0,43.0,0.9047619047619048,1
330,Tommy Robredo,Igor Sijsling,330,2,0,52,51,48,30,62,67,38,28,0.7083333333333334,0.5769230769230769,0.3333333333333333,-10,-16,2,0.8387096774193549,2.0833333333333335,81,100,-0.4467005076142132,-10.0,2.0,54.19796954314721,2,52,1,48.0,0.0,48.0,0.8387096774193549,0
331,Ernests Gulbis,Gael Monfils,331,2,1,64,65,36,32,60,55,40,22,0.4583333333333333,0.6153846153846154,0.3548387096774194,4,10,10,1.0666666666666667,2.7777777777777777,97,100,-0.4467005076142132,4.0,10.0,54.19796954314721,2,64,1,36.0,1.0,36.0,1.0666666666666667,1
332,Richard Gasquet,Michal Przysiezny,332,2,0,64,27,36,8,59,32,41,14,0.4583333333333333,0.15384615384615385,0.3655913978494624,5,-5,-6,1.0847457627118644,2.7777777777777777,35,100,-0.4467005076142132,5.0,-6.0,54.19796954314721,2,64,1,36.0,0.0,36.0,1.0847457627118644,0
333,Nikolay Davydenko,Denis Istomin,333,2,0,68,41,32,19,65,41,35,18,0.375,0.36538461538461536,0.3010752688172043,3,0,1,1.0461538461538462,3.125,60,100,-0.4467005076142132,3.0,1.0,54.19796954314721,2,68,1,32.0,0.0,32.0,1.0461538461538462,0
334,Jerzy Janowicz,Robin Haase,334,2,0,68,51,32,21,60,48,40,28,0.375,0.40384615384615385,0.3548387096774194,8,3,-7,1.1333333333333333,3.125,72,100,-0.4467005076142132,8.0,-7.0,54.19796954314721,2,68,1,32.0,0.0,32.0,1.1333333333333333,1
335,Horacio Zeballos,Stanislas Wawrinka,335,2,1,66,52,34,18,62,46,38,16,0.4166666666666667,0.34615384615384615,0.3333333333333333,4,6,2,1.064516129032258,2.9411764705882355,70,100,-0.4467005076142132,4.0,2.0,54.19796954314721,2,66,1,39.0,1.0,34.0,1.064516129032258,1
336,Kei Nishikori,Grega Zemlja,336,2,0,48,39,52,24,63,45,37,19,0.7916666666666666,0.46153846153846156,0.3225806451612903,-15,-6,5,0.7619047619047619,1.9230769230769231,63,100,-0.4467005076142132,-15.0,5.0,54.19796954314721,2,48,1,52.0,0.0,52.0,0.7619047619047619,0
337,Lukasz Kubot,Benoit Paire,337,2,1,57,34,43,20,75,46,25,8,0.6041666666666666,0.38461538461538464,0.1935483870967742,-18,-12,12,0.76,2.3255813953488373,54,100,-0.4467005076142132,-18.0,12.0,54.19796954314721,2,57,1,46.5,1.0,43.0,0.76,0
338,Fabio Fognini,Lukas Rosol,338,2,0,57,51,43,21,74,60,26,17,0.6041666666666666,0.40384615384615385,0.20430107526881722,-17,-9,4,0.7702702702702703,2.3255813953488373,72,100,-0.4467005076142132,-17.0,4.0,54.19796954314721,2,57,1,43.0,0.0,43.0,0.7702702702702703,0
339,Martin Klizan,Rafael Nadal,339,2,1,74,55,26,10,56,30,44,25,0.25,0.19230769230769232,0.3978494623655914,18,25,-15,1.3214285714285714,3.8461538461538463,65,100,-0.4467005076142132,18.0,-15.0,54.19796954314721,2,74,1,26.0,1.0,26.0,1.3214285714285714,1
340,Janko Tipsarevic,Fernando Verdasco,340,2,0,58,77,42,40,64,82,36,38,0.5833333333333334,0.7692307692307693,0.3118279569892473,-6,-5,2,0.90625,2.380952380952381,117,100,-0.4467005076142132,-6.0,2.0,54.19796954314721,2,58,1,41.0,0.0,42.0,0.90625,0
341,Federico Delbonis,Mikhail Youzhny,341,2,1,69,70,31,24,57,55,43,30,0.3541666666666667,0.46153846153846156,0.3870967741935484,12,15,-6,1.2105263157894737,3.225806451612903,94,100,-0.4467005076142132,12.0,-6.0,54.19796954314721,2,69,1,38.0,1.0,31.0,1.2105263157894737,1
342,John Isner,Ryan Harrison,342,2,0,64,88,36,32,65,81,35,37,0.4583333333333333,0.6153846153846154,0.3010752688172043,-1,7,-5,0.9846153846153847,2.7777777777777777,120,100,-0.4467005076142132,-1.0,-5.0,54.19796954314721,2,64,1,36.0,0.0,36.0,0.9846153846153847,1
343,Jack Sock,Tommy Haas,343,2,1,74,62,26,15,54,39,46,22,0.25,0.28846153846153844,0.41935483870967744,20,23,-7,1.3703703703703705,3.8461538461538463,77,100,-0.4467005076142132,20.0,-7.0,54.19796954314721,2,74,1,26.0,1.0,26.0,1.3703703703703705,1
344,Victor Hanescu,Dmitry Tursunov,344,2,0,59,31,41,9,67,33,33,9,0.5625,0.17307692307692307,0.27956989247311825,-8,-2,0,0.8805970149253731,2.4390243902439024,40,100,-0.4467005076142132,-8.0,0.0,54.19796954314721,2,59,1,44.0,0.0,41.0,0.8805970149253731,0
345,Grigor Dimitrov,Lucas Pouille,345,2,0,60,31,40,14,49,37,51,29,0.5416666666666666,0.2692307692307692,0.4731182795698925,11,-6,-15,1.2244897959183674,2.5,45,100,-0.4467005076142132,11.0,-15.0,54.19796954314721,2,60,1,40.0,0.0,40.0,1.2244897959183674,0
346,Guido Pella,Novak Djokovic,346,2,1,72,38,28,10,57,26,43,12,0.2916666666666667,0.19230769230769232,0.3870967741935484,15,12,-2,1.263157894736842,3.5714285714285716,48,100,-0.4467005076142132,15.0,-2.0,54.19796954314721,2,72,1,28.0,1.0,28.0,1.263157894736842,1
347,Roger Federer,Julien Benneteau,347,3,0,82,41,18,8,65,42,35,22,0.08333333333333333,0.15384615384615385,0.3010752688172043,17,-1,-14,1.2615384615384615,5.555555555555555,49,100,0.037383177570093455,17.0,-14.0,50.467289719626166,3,82,1,18.0,0.0,18.0,1.2615384615384615,0
348,Sam Querrey,Gilles Simon,348,3,1,60,52,40,32,58,60,42,21,0.5416666666666666,0.6153846153846154,0.3763440860215054,2,-8,11,1.0344827586206897,2.5,84,100,0.037383177570093455,2.0,11.0,50.467289719626166,3,60,1,40.0,1.0,40.0,1.0344827586206897,0
349,Marin Cilic,Viktor Troicki,349,3,1,65,61,35,20,59,43,41,27,0.4375,0.38461538461538464,0.3655913978494624,6,18,-7,1.1016949152542372,2.857142857142857,81,100,0.037383177570093455,6.0,-7.0,50.467289719626166,3,65,1,35.0,1.0,35.0,1.1016949152542372,1
350,Jeremy Chardy,Jo-Wilfried Tsonga,350,3,1,67,40,33,17,65,35,35,10,0.3958333333333333,0.3269230769230769,0.3010752688172043,2,5,7,1.0307692307692307,3.0303030303030303,57,100,0.037383177570093455,2.0,7.0,50.467289719626166,3,67,1,33.5,1.0,33.0,1.0307692307692307,1
351,David Ferrer,Feliciano Lopez,351,3,0,63,37,37,14,66,41,34,17,0.4791666666666667,0.2692307692307692,0.2903225806451613,-3,-4,-3,0.9545454545454546,2.7027027027027026,51,100,0.037383177570093455,-3.0,-3.0,50.467289719626166,3,63,1,37.0,0.0,37.0,0.9545454545454546,0
352,Kevin Anderson,Milos Raonic,352,3,0,57,49,43,29,69,54,31,19,0.6041666666666666,0.5576923076923077,0.25806451612903225,-12,-5,10,0.8260869565217391,2.3255813953488373,78,100,0.037383177570093455,-12.0,10.0,50.467289719626166,3,57,1,42.0,0.0,43.0,0.8260869565217391,0
353,Nicolas Almagro,Andreas Seppi,353,3,0,51,34,49,18,69,50,31,12,0.7291666666666666,0.34615384615384615,0.25806451612903225,-18,-16,6,0.7391304347826086,2.0408163265306123,52,100,0.037383177570093455,-18.0,6.0,50.467289719626166,3,51,1,49.0,0.0,49.0,0.7391304347826086,0
354,Tommy Robredo,Gael Monfils,354,3,0,68,73,32,27,70,74,30,30,0.375,0.5192307692307693,0.24731182795698925,-2,-1,-3,0.9714285714285714,3.125,100,100,0.037383177570093455,-2.0,-3.0,50.467289719626166,3,68,1,32.0,0.0,32.0,0.9714285714285714,0
355,Richard Gasquet,Nikolay Davydenko,355,3,0,76,46,24,9,68,40,32,19,0.20833333333333334,0.17307692307692307,0.26881720430107525,8,6,-10,1.1176470588235294,4.166666666666667,55,100,0.037383177570093455,13.5,-10.0,50.467289719626166,3,77,2,24.0,0.0,24.0,1.1176470588235294,1
356,Jerzy Janowicz,Stanislas Wawrinka,356,3,1,58,54,42,31,61,58,39,23,0.5833333333333334,0.5961538461538461,0.34408602150537637,-3,-4,8,0.9508196721311475,2.380952380952381,85,100,0.037383177570093455,-3.0,8.0,50.467289719626166,3,58,1,42.0,1.0,42.0,0.9508196721311475,0
357,Kei Nishikori,Benoit Paire,357,3,0,43,40,57,36,63,53,37,23,0.8958333333333334,0.6923076923076923,0.3225806451612903,-20,-13,13,0.6825396825396826,1.7543859649122806,76,100,0.037383177570093455,-20.0,13.0,50.467289719626166,3,43,1,49.5,0.0,57.0,0.6825396825396826,0
358,Fabio Fognini,Rafael Nadal,358,3,1,78,52,22,14,67,47,33,26,0.16666666666666666,0.2692307692307692,0.27956989247311825,11,5,-12,1.164179104477612,4.545454545454546,66,100,0.037383177570093455,11.0,-12.0,50.467289719626166,3,78,1,27.5,1.0,22.0,1.164179104477612,1
359,Janko Tipsarevic,Mikhail Youzhny,359,3,1,64,40,36,21,49,28,51,25,0.4583333333333333,0.40384615384615385,0.4731182795698925,15,12,-4,1.3061224489795917,2.7777777777777777,61,100,0.037383177570093455,15.0,-4.0,50.467289719626166,3,64,1,36.0,1.0,36.0,1.3061224489795917,1
360,John Isner,Tommy Haas,360,3,0,63,99,37,52,78,132,22,24,0.4791666666666667,1.0,0.16129032258064516,-15,-33,28,0.8076923076923077,2.7027027027027026,151,100,0.037383177570093455,-15.0,28.0,50.467289719626166,3,63,1,37.0,0.0,37.0,0.8076923076923077,0
361,Philipp Kohlschreiber,Victor Hanescu,361,3,0,73,31,27,8,59,43,41,20,0.2708333333333333,0.15384615384615385,0.3655913978494624,14,-12,-12,1.2372881355932204,3.7037037037037037,39,100,0.037383177570093455,14.0,-12.0,50.467289719626166,3,73,1,27.0,0.0,27.0,1.2372881355932204,0
362,Grigor Dimitrov,Novak Djokovic,362,3,1,68,39,32,13,69,33,31,9,0.375,0.25,0.25806451612903225,-1,6,4,0.9855072463768116,3.125,52,100,0.037383177570093455,-1.0,4.0,50.467289719626166,3,68,1,32.0,1.0,32.0,0.9855072463768116,1
363,Roger Federer,Gilles Simon,363,4,0,61,65,39,28,64,56,36,23,0.5208333333333334,0.5384615384615384,0.3118279569892473,-3,9,5,0.953125,2.5641025641025643,93,100,0.38181818181818183,-3.0,5.0,55.54545454545455,4,61,1,39.0,0.0,39.0,0.953125,1
364,Viktor Troicki,Jo-Wilfried Tsonga,364,4,1,77,45,23,15,62,34,38,15,0.1875,0.28846153846153844,0.3333333333333333,15,11,0,1.2419354838709677,4.3478260869565215,60,100,0.38181818181818183,15.0,0.0,55.54545454545455,4,77,1,35.5,1.0,23.0,1.2419354838709677,1
365,David Ferrer,Kevin Anderson,365,4,0,71,34,29,7,52,28,48,24,0.3125,0.1346153846153846,0.44086021505376344,19,6,-17,1.3653846153846154,3.4482758620689653,41,100,0.38181818181818183,19.0,-17.0,55.54545454545455,4,71,1,29.0,0.0,29.0,1.3653846153846154,1
366,Nicolas Almagro,Tommy Robredo,366,4,1,63,73,37,31,63,71,37,31,0.4791666666666667,0.5961538461538461,0.3225806451612903,0,2,0,1.0,2.7027027027027026,104,100,0.38181818181818183,0.0,0.0,55.54545454545455,4,63,1,37.0,1.0,37.0,1.0,1
367,Richard Gasquet,Stanislas Wawrinka,367,4,1,63,81,37,41,60,87,40,38,0.4791666666666667,0.7884615384615384,0.3548387096774194,3,-6,3,1.05,2.7027027027027026,122,100,0.38181818181818183,3.0,3.0,55.54545454545455,4,63,1,40.5,1.0,37.0,1.05,0
368,Kei Nishikori,Rafael Nadal,368,4,1,69,39,31,16,65,27,35,15,0.3541666666666667,0.3076923076923077,0.3010752688172043,4,12,1,1.0615384615384615,3.225806451612903,55,100,0.38181818181818183,4.5,-0.5,55.54545454545455,4,71,2,30.0,1.0,30.0,1.0686480186480187,1
369,Mikhail Youzhny,Tommy Haas,369,4,1,61,31,39,14,63,16,37,12,0.5208333333333334,0.2692307692307692,0.3225806451612903,-2,15,2,0.9682539682539683,2.5641025641025643,45,100,0.38181818181818183,-4.5,1.5,55.54545454545455,4,61,2,39.0,0.5,39.0,0.9682539682539683,1
370,Philipp Kohlschreiber,Novak Djokovic,370,4,1,74,71,26,23,55,48,45,28,0.25,0.4423076923076923,0.40860215053763443,19,23,-5,1.3454545454545455,3.8461538461538463,94,100,0.38181818181818183,19.0,-5.0,55.54545454545455,4,74,1,26.0,1.0,26.0,1.3454545454545455,1
371,Roger Federer,Jo-Wilfried Tsonga,371,5,1,75,46,25,10,67,39,33,14,0.22916666666666666,0.19230769230769232,0.27956989247311825,8,7,-4,1.1194029850746268,4.0,56,100,-1.2222222222222223,1.5,-3.0,54.333333333333336,5,75,2,25.0,0.5,25.0,1.1194029850746268,1
372,David Ferrer,Tommy Robredo,372,5,0,59,22,41,9,47,25,53,22,0.5625,0.17307692307692307,0.4946236559139785,12,-3,-13,1.2553191489361701,2.4390243902439024,31,100,-1.2222222222222223,12.0,-13.0,54.333333333333336,5,59,1,41.0,0.0,41.0,1.2553191489361701,0
373,Stanislas Wawrinka,Rafael Nadal,373,5,1,75,40,25,11,60,30,40,12,0.22916666666666666,0.21153846153846154,0.3548387096774194,15,10,-1,1.25,4.0,51,100,-1.2222222222222223,19.0,-6.5,54.333333333333336,7,78,2,26.0,0.5,25.0,1.25,1
374,Tommy Haas,Novak Djokovic,374,5,1,64,41,36,22,60,48,40,21,0.4583333333333333,0.4230769230769231,0.3548387096774194,4,-7,1,1.0666666666666667,2.7777777777777777,63,100,-1.2222222222222223,4.0,1.0,54.333333333333336,5,64,1,36.0,1.0,36.0,1.0666666666666667,0
375,Jo-Wilfried Tsonga,David Ferrer,375,6,1,60,35,40,23,58,37,42,17,0.5416666666666666,0.4423076923076923,0.3763440860215054,2,-2,6,1.0344827586206897,2.5,58,100,-3.2857142857142856,2.0,6.0,57.357142857142854,6,60,1,40.0,1.0,40.0,1.0344827586206897,0
376,Rafael Nadal,Novak Djokovic,376,6,0,67,76,33,30,64,73,36,35,0.3958333333333333,0.5769230769230769,0.3118279569892473,3,3,-5,1.046875,3.0303030303030303,106,100,-3.2857142857142856,3.5,-6.5,57.357142857142854,6,68,2,33.0,0.0,33.0,1.046875,1
377,David Ferrer,Rafael Nadal,377,7,1,70,43,30,11,62,31,38,8,0.3333333333333333,0.21153846153846154,0.3333333333333333,8,12,3,1.1290322580645162,3.3333333333333335,54,100,5.285714285714286,8.0,3.0,47.857142857142854,7,70,1,26.0,1.0,30.0,1.1290322580645162,1
378,Maria Sharapova,Su-Wei Hsieh,378,1,0,62,18,38,5,68,25,32,8,0.5,0.09615384615384616,0.26881720430107525,-6,-7,-3,0.9117647058823529,2.6315789473684212,23,100,0.5652985074626866,-6.0,-3.0,57.115671641791046,1,62,1,40.0,0.0,38.0,0.9117647058823529,0
379,Tsvetana Pironkova,Eugenie Bouchard,379,1,1,57,23,43,17,66,28,34,6,0.6041666666666666,0.3269230769230769,0.2903225806451613,-9,-5,11,0.8636363636363636,2.3255813953488373,40,100,0.5652985074626866,-9.0,11.0,57.115671641791046,1,57,1,39.5,1.0,43.0,0.8636363636363636,0
380,Vesna Dolonc,Jie Zheng,380,1,1,76,30,24,5,76,35,24,6,0.20833333333333334,0.09615384615384616,0.1827956989247312,0,-5,-1,1.0,4.166666666666667,35,100,0.5652985074626866,0.0,-1.0,57.115671641791046,1,76,1,24.0,1.0,24.0,1.0,0
381,Melanie Oudin,Tamira Paszek,381,1,0,59,16,41,8,63,27,37,9,0.5625,0.15384615384615385,0.3225806451612903,-4,-11,-1,0.9365079365079365,2.4390243902439024,24,100,0.5652985074626866,-4.0,-1.0,57.115671641791046,1,59,1,41.0,0.0,41.0,0.9365079365079365,0
382,Sloane Stephens,Karin Knapp,382,1,0,57,18,43,13,65,22,35,10,0.6041666666666666,0.25,0.3010752688172043,-8,-4,3,0.8769230769230769,2.3255813953488373,31,100,0.5652985074626866,-8.0,3.0,57.115671641791046,1,57,1,43.0,0.0,43.0,0.8769230769230769,0
383,Alexandra Cadantu,Vania King,383,1,1,74,27,26,11,72,28,28,9,0.25,0.21153846153846154,0.22580645161290322,2,-1,2,1.0277777777777777,3.8461538461538463,38,100,0.5652985074626866,2.0,2.0,57.115671641791046,1,74,1,26.0,1.0,26.0,1.0277777777777777,0
384,Elena Baltacha,Marina Erakovic,384,1,1,66,23,34,8,69,11,31,6,0.4166666666666667,0.15384615384615385,0.25806451612903225,-3,12,2,0.9565217391304348,2.9411764705882355,31,100,0.5652985074626866,-3.0,2.0,57.115671641791046,1,66,1,34.0,1.0,34.0,0.9565217391304348,1
385,Lesia Tsurenko,Dominika Cibulkova,385,1,1,60,24,40,11,55,12,45,7,0.5416666666666666,0.21153846153846154,0.40860215053763443,5,12,4,1.0909090909090908,2.5,35,100,0.5652985074626866,5.0,4.0,57.115671641791046,1,60,1,40.0,1.0,40.0,1.0909090909090908,1
386,Samantha Stosur,Kimiko Date-Krumm,386,1,0,79,15,21,3,59,19,41,12,0.14583333333333334,0.057692307692307696,0.3655913978494624,20,-4,-9,1.3389830508474576,4.761904761904762,18,100,0.5652985074626866,20.0,-9.0,57.115671641791046,1,79,1,21.0,0.0,21.0,1.3389830508474576,0
387,Lauren Davis,Kristina Mladenovic,387,1,1,58,27,42,13,72,22,28,5,0.5833333333333334,0.25,0.22580645161290322,-14,5,8,0.8055555555555556,2.380952380952381,40,100,0.5652985074626866,-14.0,8.0,57.115671641791046,1,58,1,47.0,1.0,42.0,0.8055555555555556,1
388,Garbine Muguruza,Karolina Pliskova,388,1,0,60,41,40,20,69,49,31,13,0.5416666666666666,0.38461538461538464,0.25806451612903225,-9,-8,7,0.8695652173913043,2.5,61,100,0.5652985074626866,-9.0,7.0,57.115671641791046,1,60,1,40.0,0.0,40.0,0.8695652173913043,0
389,Daniela Hantuchova,Jelena Jankovic,389,1,1,78,40,22,7,68,38,32,17,0.16666666666666666,0.1346153846153846,0.26881720430107525,10,2,-10,1.1470588235294117,4.545454545454546,47,100,0.5652985074626866,10.0,-10.0,57.115671641791046,1,78,1,31.0,1.0,22.0,1.1470588235294117,1
390,Lucie Safarova,Jamie Hampton,390,1,1,60,50,40,24,67,53,33,19,0.5416666666666666,0.46153846153846156,0.27956989247311825,-7,-3,5,0.8955223880597015,2.5,74,100,0.5652985074626866,-7.0,5.0,57.115671641791046,1,60,1,40.0,1.0,40.0,0.8955223880597015,0
391,Yanina Wickmayer,Anna Karolina Schmiedlova,391,1,1,62,40,38,16,59,39,41,22,0.5,0.3076923076923077,0.3655913978494624,3,1,-6,1.0508474576271187,2.6315789473684212,56,100,0.5652985074626866,3.0,-6.0,57.115671641791046,1,62,1,38.0,1.0,38.0,1.0508474576271187,1
392,Camila Giorgi,Shuai Peng,392,1,1,54,28,46,14,53,24,47,8,0.6666666666666666,0.2692307692307692,0.43010752688172044,1,4,6,1.0188679245283019,2.1739130434782608,42,100,0.5652985074626866,1.0,6.0,57.115671641791046,1,54,1,46.0,1.0,46.0,1.0188679245283019,1
393,Aravane Rezai,Petra Kvitova,393,1,1,69,35,31,13,56,27,44,12,0.3541666666666667,0.25,0.3978494623655914,13,8,1,1.2321428571428572,3.225806451612903,48,100,0.5652985074626866,13.0,1.0,57.115671641791046,1,69,1,31.0,1.0,31.0,1.2321428571428572,1
394,Victoria Azarenka,Elena Vesnina,394,1,0,74,21,26,6,70,31,30,6,0.25,0.11538461538461539,0.24731182795698925,4,-10,0,1.0571428571428572,3.8461538461538463,27,100,0.5652985074626866,4.0,0.0,57.115671641791046,1,74,1,26.0,0.0,26.0,1.0571428571428572,0
395,Annika Beck,Sandra Zahlavova,395,1,0,69,18,31,7,83,28,17,5,0.3541666666666667,0.1346153846153846,0.10752688172043011,-14,-10,2,0.8313253012048193,3.225806451612903,25,100,0.5652985074626866,-14.0,2.0,57.115671641791046,1,69,1,31.0,0.0,31.0,0.8313253012048193,0
396,Silvia Soler-Espinosa,Irina-Camelia Begu,396,1,0,74,26,26,6,56,23,44,15,0.25,0.11538461538461539,0.3978494623655914,18,3,-9,1.3214285714285714,3.8461538461538463,32,100,0.5652985074626866,18.0,-9.0,57.115671641791046,1,74,1,26.0,0.0,26.0,1.3214285714285714,1
397,Maria Joao Koehler,Alize Cornet,397,1,1,70,28,30,11,60,19,40,8,0.3333333333333333,0.21153846153846154,0.3548387096774194,10,9,3,1.1666666666666667,3.3333333333333335,39,100,0.5652985074626866,10.0,3.0,57.115671641791046,1,70,1,27.5,1.0,30.0,1.1666666666666667,1
398,Kirsten Flipkens,Flavia Pennetta,398,1,0,41,21,59,17,45,31,55,23,0.9375,0.3269230769230769,0.5161290322580645,-4,-10,-6,0.9111111111111111,1.694915254237288,38,100,0.5652985074626866,-4.0,-6.0,57.115671641791046,1,41,1,59.5,0.0,59.0,0.9111111111111111,0
399,Francesca Schiavone,Melinda Czink,399,1,0,57,23,43,12,57,26,43,14,0.6041666666666666,0.23076923076923078,0.3870967741935484,0,-3,-2,1.0,2.3255813953488373,35,100,0.5652985074626866,0.0,-2.0,57.115671641791046,1,57,1,43.0,0.0,43.0,1.0,0
400,Mariana Duque-Marino,Kristyna Pliskova,400,1,0,60,18,40,9,65,23,35,9,0.5416666666666666,0.17307692307692307,0.3010752688172043,-5,-5,0,0.9230769230769231,2.5,27,100,0.5652985074626866,-5.0,0.0,57.115671641791046,1,60,1,40.0,0.0,40.0,0.9230769230769231,0
401,Olga Govortsova,Marion Bartoli,401,1,1,62,54,38,25,62,42,38,16,0.5,0.4807692307692308,0.3333333333333333,0,12,9,1.0,2.6315789473684212,79,100,0.5652985074626866,0.0,9.0,57.115671641791046,1,62,1,38.0,1.0,38.0,1.0,1
402,Maria Kirilenko,Nina Bratchikova,402,1,0,69,15,31,4,51,19,49,12,0.3541666666666667,0.07692307692307693,0.45161290322580644,18,-4,-8,1.3529411764705883,3.225806451612903,19,100,0.5652985074626866,18.0,-8.0,57.115671641791046,1,69,1,31.0,0.0,31.0,1.3529411764705883,0
403,Lucie Hradecka,Ashleigh Barty,403,1,1,53,32,47,23,57,31,43,18,0.6875,0.4423076923076923,0.3870967741935484,-4,1,5,0.9298245614035088,2.127659574468085,55,100,0.5652985074626866,-4.0,5.0,57.115671641791046,1,53,1,47.0,1.0,47.0,0.9298245614035088,1
404,Heather Watson,Stefanie Voegele,404,1,1,64,41,36,16,67,44,33,17,0.4583333333333333,0.3076923076923077,0.27956989247311825,-3,-3,-1,0.9552238805970149,2.7777777777777777,57,100,0.5652985074626866,-3.0,-1.0,57.115671641791046,1,64,1,36.0,1.0,36.0,0.9552238805970149,0
405,Kaia Kanepi,Klara Zakopalova,405,1,0,58,22,42,11,70,32,30,8,0.5833333333333334,0.21153846153846154,0.24731182795698925,-12,-10,3,0.8285714285714286,2.380952380952381,33,100,0.5652985074626866,-12.0,3.0,57.115671641791046,1,58,1,42.0,0.0,42.0,0.8285714285714286,0
406,Yaroslava Shvedova,Coco Vandeweghe,406,1,0,53,24,47,12,64,30,36,14,0.6875,0.23076923076923078,0.3118279569892473,-11,-6,-2,0.828125,2.127659574468085,36,100,0.5652985074626866,-11.0,-2.0,57.115671641791046,1,53,1,47.0,0.0,47.0,0.828125,0
407,Paula Ormaechea,Tatjana Maria,407,1,0,60,30,40,18,49,25,51,21,0.5416666666666666,0.34615384615384615,0.4731182795698925,11,5,-3,1.2244897959183674,2.5,48,100,0.5652985074626866,11.0,-3.0,57.115671641791046,1,60,1,40.0,0.0,40.0,1.2244897959183674,1
408,Lourdes Dominguez Lino,Bethanie Mattek-Sands,408,1,1,54,24,46,14,47,12,53,14,0.6666666666666666,0.2692307692307692,0.4946236559139785,7,12,0,1.148936170212766,2.1739130434782608,38,100,0.5652985074626866,7.0,0.0,57.115671641791046,1,54,1,44.5,1.0,46.0,1.148936170212766,1
409,A. Medina Garrigues,Na Li,409,1,1,71,31,29,7,57,18,43,7,0.3125,0.1346153846153846,0.3870967741935484,14,13,0,1.2456140350877194,3.4482758620689653,38,100,0.5652985074626866,14.0,0.0,57.115671641791046,1,71,1,26.5,1.0,29.0,1.2456140350877194,1
410,Sara Errani,Arantxa Rus,410,1,0,52,11,48,2,85,18,15,3,0.7083333333333334,0.038461538461538464,0.08602150537634409,-33,-7,-1,0.611764705882353,2.0833333333333335,13,100,0.5652985074626866,-33.0,-1.0,57.115671641791046,1,52,1,48.0,0.0,48.0,0.611764705882353,0
411,Yulia Putintseva,Ayumi Morita,411,1,0,65,17,35,9,58,22,42,16,0.4375,0.17307692307692307,0.3763440860215054,7,-5,-7,1.1206896551724137,2.857142857142857,26,100,0.5652985074626866,7.0,-7.0,57.115671641791046,1,65,1,35.0,0.0,35.0,1.1206896551724137,0
412,Julia Glushko,Maria-Teresa Torro-Flor,412,1,1,77,32,23,7,78,22,22,5,0.1875,0.1346153846153846,0.16129032258064516,-1,10,2,0.9871794871794872,4.3478260869565215,39,100,0.5652985074626866,-1.0,2.0,57.115671641791046,1,77,1,23.0,1.0,23.0,0.9871794871794872,1
413,Sofia Arvidsson,Sabine Lisicki,413,1,1,52,27,48,15,70,29,30,10,0.7083333333333334,0.28846153846153844,0.24731182795698925,-18,-2,5,0.7428571428571429,2.0833333333333335,42,100,0.5652985074626866,-18.0,5.0,57.115671641791046,1,52,1,48.0,1.0,48.0,0.7428571428571429,0
414,Carla Suarez Navarro,Simona Halep,414,1,0,74,34,26,9,63,31,37,17,0.25,0.17307692307692307,0.3225806451612903,11,3,-8,1.1746031746031746,3.8461538461538463,43,100,0.5652985074626866,11.0,-8.0,57.115671641791046,1,74,1,26.0,0.0,26.0,1.1746031746031746,1
415,Shelby Rogers,Irena Pavlovic,415,1,0,59,24,41,11,58,26,42,15,0.5625,0.21153846153846154,0.3763440860215054,1,-2,-4,1.0172413793103448,2.4390243902439024,35,100,0.5652985074626866,1.0,-4.0,57.115671641791046,1,59,1,41.0,0.0,41.0,1.0172413793103448,0
416,Misaki Doi,Madison Keys,416,1,1,66,29,34,8,62,16,38,9,0.4166666666666667,0.15384615384615385,0.3333333333333333,4,13,-1,1.064516129032258,2.9411764705882355,37,100,0.5652985074626866,4.0,-1.0,57.115671641791046,1,66,1,34.0,1.0,34.0,1.064516129032258,1
417,Monica Puig,Nadia Petrova,417,1,0,58,37,42,16,52,40,48,21,0.5833333333333334,0.3076923076923077,0.44086021505376344,6,-3,-5,1.1153846153846154,2.380952380952381,53,100,0.5652985074626866,6.0,-5.0,57.115671641791046,1,58,1,42.0,0.0,42.0,1.1153846153846154,0
418,Ana Ivanovic,Petra Martic,418,1,0,62,30,38,17,54,37,46,24,0.5,0.3269230769230769,0.41935483870967744,8,-7,-7,1.1481481481481481,2.6315789473684212,47,100,0.5652985074626866,8.0,-7.0,57.115671641791046,1,62,1,38.0,0.0,38.0,1.1481481481481481,0
419,Mathilde Johansson,Chanelle Scheepers,419,1,0,54,16,46,13,68,29,32,9,0.6666666666666666,0.25,0.26881720430107525,-14,-13,4,0.7941176470588235,2.1739130434782608,29,100,0.5652985074626866,-14.0,4.0,57.115671641791046,1,54,1,46.5,0.0,46.0,0.7941176470588235,0
420,Claire Feuerstein,Virginie Razzano,420,1,1,75,46,25,9,55,29,45,19,0.22916666666666666,0.17307692307692307,0.40860215053763443,20,17,-10,1.3636363636363635,4.0,55,100,0.5652985074626866,20.0,-10.0,57.115671641791046,1,75,1,25.0,1.0,25.0,1.3636363636363635,1
421,Zuzana Kucova,Julia Goerges,421,1,0,54,22,46,14,76,41,24,13,0.6666666666666666,0.2692307692307692,0.1827956989247312,-22,-19,1,0.7105263157894737,2.1739130434782608,36,100,0.5652985074626866,-22.0,1.0,57.115671641791046,1,54,1,48.0,0.0,46.0,0.7105263157894737,0
422,Venus Williams,Urszula Radwanska,422,1,1,68,48,32,16,65,38,35,13,0.375,0.3076923076923077,0.3010752688172043,3,10,3,1.0461538461538462,3.125,64,100,0.5652985074626866,3.0,3.0,57.115671641791046,1,68,1,32.0,1.0,32.0,1.0461538461538462,1
423,Mandy Minella,Dinah Pfizenmaier,423,1,1,67,28,33,5,57,17,43,8,0.3958333333333333,0.09615384615384616,0.3870967741935484,10,11,-3,1.1754385964912282,3.0303030303030303,33,100,0.5652985074626866,10.0,-3.0,57.115671641791046,1,67,1,42.5,1.0,33.0,1.1754385964912282,1
424,Donna Vekic,Mallory Burdette,424,1,1,68,27,32,11,63,21,37,7,0.375,0.21153846153846154,0.3225806451612903,5,6,4,1.0793650793650793,3.125,38,100,0.5652985074626866,5.0,4.0,57.115671641791046,1,68,1,32.0,1.0,32.0,1.0793650793650793,1
425,Shahar Peer,Agnieszka Radwanska,425,1,1,67,17,33,9,56,15,44,7,0.3958333333333333,0.17307692307692307,0.3978494623655914,11,2,2,1.1964285714285714,3.0303030303030303,26,100,0.5652985074626866,11.0,2.0,57.115671641791046,1,67,1,37.0,1.0,33.0,1.1964285714285714,1
426,Angelique Kerber,Mona Barthel,426,1,0,57,30,43,16,54,31,46,20,0.6041666666666666,0.3076923076923077,0.41935483870967744,3,-1,-4,1.0555555555555556,2.3255813953488373,46,100,0.5652985074626866,3.0,-4.0,57.115671641791046,1,57,1,43.0,0.0,43.0,1.0555555555555556,0
427,Christina McHale,Jana Cepelova,427,1,1,78,52,22,9,70,52,30,10,0.16666666666666666,0.17307692307692307,0.24731182795698925,8,0,-1,1.1142857142857143,4.545454545454546,61,100,0.5652985074626866,8.0,-1.0,57.115671641791046,1,78,1,22.0,1.0,22.0,1.1142857142857143,0
428,Elina Svitolina,Romina Oprandi,428,1,0,67,35,33,7,61,30,39,19,0.3958333333333333,0.1346153846153846,0.34408602150537637,6,5,-12,1.098360655737705,3.0303030303030303,42,100,0.5652985074626866,6.0,-12.0,57.115671641791046,1,67,1,33.0,0.0,33.0,1.098360655737705,1
429,Mirjana Lucic-Baroni,Varvara Lepchenko,429,1,1,65,23,35,8,56,15,44,8,0.4375,0.15384615384615385,0.3978494623655914,9,8,0,1.1607142857142858,2.857142857142857,31,100,0.5652985074626866,9.0,0.0,57.115671641791046,1,65,1,35.0,1.0,35.0,1.1607142857142858,1
430,Ekaterina Makarova,Svetlana Kuznetsova,430,1,1,54,15,46,15,70,25,30,11,0.6666666666666666,0.28846153846153844,0.24731182795698925,-16,-10,4,0.7714285714285715,2.1739130434782608,30,100,0.5652985074626866,-16.0,4.0,57.115671641791046,1,54,1,46.0,1.0,46.0,0.7714285714285715,0
431,Magdalena Rybarikova,Pauline Parmentier,431,1,0,54,12,46,6,73,19,27,6,0.6666666666666666,0.11538461538461539,0.21505376344086022,-19,-7,0,0.7397260273972602,2.1739130434782608,18,100,0.5652985074626866,-19.0,0.0,57.115671641791046,1,54,1,41.5,0.0,46.0,0.7397260273972602,0
432,Bojana Jovanovski,Barbora Zahlavova Strycova,432,1,0,71,23,29,6,80,31,20,5,0.3125,0.11538461538461539,0.13978494623655913,-9,-8,1,0.8875,3.4482758620689653,29,100,0.5652985074626866,-9.0,1.0,57.115671641791046,1,71,1,29.0,0.0,29.0,0.8875,0
433,Laura Robson,Caroline Wozniacki,433,1,1,76,27,24,8,56,18,44,5,0.20833333333333334,0.15384615384615385,0.3978494623655914,20,9,3,1.3571428571428572,4.166666666666667,35,100,0.5652985074626866,20.0,3.0,57.115671641791046,1,76,1,24.0,1.0,24.0,1.3571428571428572,1
434,Roberta Vinci,Stephanie Foretz Gacon,434,1,0,66,16,34,5,60,20,40,12,0.4166666666666667,0.09615384615384616,0.3548387096774194,6,-4,-7,1.1,2.9411764705882355,21,100,0.5652985074626866,6.0,-7.0,57.115671641791046,1,66,1,34.0,0.0,34.0,1.1,0
435,Grace Min,Galina Voskoboeva,435,1,1,55,30,45,18,69,34,31,17,0.6458333333333334,0.34615384615384615,0.25806451612903225,-14,-4,1,0.7971014492753623,2.2222222222222223,48,100,0.5652985074626866,-14.0,1.0,57.115671641791046,1,55,1,40.5,1.0,45.0,0.7971014492753623,0
436,Olga Puchkova,Petra Cetkovska,436,1,1,69,25,31,8,62,11,38,3,0.3541666666666667,0.15384615384615385,0.3333333333333333,7,14,5,1.1129032258064515,3.225806451612903,33,100,0.5652985074626866,7.0,5.0,57.115671641791046,1,69,1,31.0,1.0,31.0,1.1129032258064515,1
437,Andrea Hlavackova,Anastasia Pavlyuchenkova,437,1,1,54,31,46,22,72,46,28,11,0.6666666666666666,0.4230769230769231,0.22580645161290322,-18,-15,11,0.75,2.1739130434782608,53,100,0.5652985074626866,-18.0,11.0,57.115671641791046,1,54,1,46.0,1.0,46.0,0.75,0
438,Sorana Cirstea,Kiki Bertens,438,1,0,63,42,37,12,65,40,35,21,0.4791666666666667,0.23076923076923078,0.3010752688172043,-2,2,-9,0.9692307692307692,2.7027027027027026,54,100,0.5652985074626866,-2.0,-9.0,57.115671641791046,1,63,1,38.0,0.0,37.0,0.9692307692307692,1
439,Johanna Larsson,Monica Niculescu,439,1,0,82,15,18,4,64,22,36,8,0.08333333333333333,0.07692307692307693,0.3118279569892473,18,-7,-4,1.28125,5.555555555555555,19,100,0.5652985074626866,18.0,-4.0,57.115671641791046,1,82,1,18.0,0.0,18.0,1.28125,0
440,Caroline Garcia,Yuliya Beygelzimer,440,1,0,59,24,41,13,60,29,40,13,0.5625,0.25,0.3548387096774194,-1,-5,0,0.9833333333333333,2.4390243902439024,37,100,0.5652985074626866,-1.0,0.0,57.115671641791046,1,59,1,41.0,0.0,41.0,0.9833333333333333,0
441,Anna Tatishvili,Serena Williams,441,1,1,73,21,27,7,58,11,42,6,0.2708333333333333,0.1346153846153846,0.3763440860215054,15,10,1,1.2586206896551724,3.7037037037037037,28,100,0.5652985074626866,15.0,1.0,57.115671641791046,1,73,1,34.0,1.0,27.0,1.2586206896551724,1
442,Maria Sharapova,Eugenie Bouchard,442,2,0,57,17,43,10,52,19,48,11,0.6041666666666666,0.19230769230769232,0.44086021505376344,5,-2,-1,1.0961538461538463,2.3255813953488373,27,100,-0.4467005076142132,5.0,-1.0,54.19796954314721,2,57,1,46.5,0.0,43.0,1.0961538461538463,0
443,Jie Zheng,Melanie Oudin,443,2,0,65,12,35,7,73,26,27,7,0.4375,0.1346153846153846,0.21505376344086022,-8,-14,0,0.8904109589041096,2.857142857142857,19,100,-0.4467005076142132,-8.0,0.0,54.19796954314721,2,65,1,35.0,0.0,35.0,0.8904109589041096,0
444,Sloane Stephens,Vania King,444,2,0,82,17,18,6,75,26,25,5,0.08333333333333333,0.11538461538461539,0.1935483870967742,7,-9,1,1.0933333333333333,5.555555555555555,23,100,-0.4467005076142132,7.0,1.0,54.19796954314721,2,82,1,18.0,0.0,18.0,1.0933333333333333,0
445,Marina Erakovic,Dominika Cibulkova,445,2,0,56,31,44,16,48,25,52,21,0.625,0.3076923076923077,0.4838709677419355,8,6,-5,1.1666666666666667,2.272727272727273,47,100,-0.4467005076142132,8.0,-5.0,54.19796954314721,2,56,1,44.0,0.0,44.0,1.1666666666666667,1
446,Samantha Stosur,Kristina Mladenovic,446,2,0,55,27,45,16,75,40,25,6,0.6458333333333334,0.3076923076923077,0.1935483870967742,-20,-13,10,0.7333333333333333,2.2222222222222223,43,100,-0.4467005076142132,-20.0,10.0,54.19796954314721,2,55,1,45.0,0.0,45.0,0.7333333333333333,0
447,Garbine Muguruza,Jelena Jankovic,447,2,1,60,16,40,11,54,13,46,8,0.5416666666666666,0.21153846153846154,0.41935483870967744,6,3,3,1.1111111111111112,2.5,27,100,-0.4467005076142132,6.0,3.0,54.19796954314721,2,60,1,40.5,1.0,40.0,1.1111111111111112,1
448,Jamie Hampton,Anna Karolina Schmiedlova,448,2,0,70,28,30,7,57,22,43,15,0.3333333333333333,0.1346153846153846,0.3870967741935484,13,6,-8,1.2280701754385965,3.3333333333333335,35,100,-0.4467005076142132,13.0,-8.0,54.19796954314721,2,70,1,30.0,0.0,30.0,1.2280701754385965,1
449,Shuai Peng,Petra Kvitova,449,2,1,53,20,47,13,73,22,27,5,0.6875,0.25,0.21505376344086022,-20,-2,8,0.726027397260274,2.127659574468085,33,100,-0.4467005076142132,-20.0,8.0,54.19796954314721,2,53,1,47.0,1.0,47.0,0.726027397260274,0
450,Victoria Azarenka,Annika Beck,450,2,0,66,22,34,7,63,24,37,7,0.4166666666666667,0.1346153846153846,0.3225806451612903,3,-2,0,1.0476190476190477,2.9411764705882355,29,100,-0.4467005076142132,3.0,0.0,54.19796954314721,2,66,1,29.5,0.0,34.0,1.0476190476190477,0
451,Silvia Soler-Espinosa,Alize Cornet,451,2,1,74,24,26,10,53,13,47,10,0.25,0.19230769230769232,0.43010752688172044,21,11,0,1.3962264150943395,3.8461538461538463,34,100,-0.4467005076142132,21.0,0.0,54.19796954314721,2,74,1,33.5,1.0,26.0,1.3962264150943395,1
452,Kirsten Flipkens,Francesca Schiavone,452,2,1,62,34,38,20,53,33,47,13,0.5,0.38461538461538464,0.43010752688172044,9,1,7,1.169811320754717,2.6315789473684212,54,100,-0.4467005076142132,9.0,7.0,54.19796954314721,2,62,1,38.0,1.0,38.0,1.169811320754717,1
453,Mariana Duque-Marino,Marion Bartoli,453,2,1,62,34,38,14,57,32,43,14,0.5,0.2692307692307692,0.3870967741935484,5,2,0,1.087719298245614,2.6315789473684212,48,100,-0.4467005076142132,5.0,0.0,54.19796954314721,2,62,1,38.0,1.0,38.0,1.087719298245614,1
454,Maria Kirilenko,Ashleigh Barty,454,2,0,61,6,39,4,75,9,25,1,0.5208333333333334,0.07692307692307693,0.1935483870967742,-14,-3,3,0.8133333333333334,2.5641025641025643,10,100,-0.4467005076142132,-14.0,3.0,54.19796954314721,2,61,1,39.0,0.0,39.0,0.8133333333333334,0
455,Stefanie Voegele,Kaia Kanepi,455,2,1,71,20,29,5,58,13,42,9,0.3125,0.09615384615384616,0.3763440860215054,13,7,-4,1.2241379310344827,3.4482758620689653,25,100,-0.4467005076142132,13.0,-4.0,54.19796954314721,2,71,1,29.0,1.0,29.0,1.2241379310344827,1
456,Yaroslava Shvedova,Paula Ormaechea,456,2,1,64,27,36,14,74,26,26,7,0.4583333333333333,0.2692307692307692,0.20430107526881722,-10,1,7,0.8648648648648649,2.7777777777777777,41,100,-0.4467005076142132,-10.0,7.0,54.19796954314721,2,64,1,36.0,1.0,36.0,0.8648648648648649,1
457,Bethanie Mattek-Sands,Na Li,457,2,0,63,34,37,17,54,35,46,18,0.4791666666666667,0.3269230769230769,0.41935483870967744,9,-1,-1,1.1666666666666667,2.7027027027027026,51,100,-0.4467005076142132,9.0,-1.0,54.19796954314721,2,63,1,38.5,0.0,37.0,1.1666666666666667,0
458,Sara Errani,Yulia Putintseva,458,2,0,64,11,36,5,87,28,13,3,0.4583333333333333,0.09615384615384616,0.06451612903225806,-23,-17,2,0.735632183908046,2.7777777777777777,16,100,-0.4467005076142132,-23.0,2.0,54.19796954314721,2,64,1,36.0,0.0,36.0,0.735632183908046,0
459,Maria-Teresa Torro-Flor,Sabine Lisicki,459,2,1,68,26,32,8,74,17,26,5,0.375,0.15384615384615385,0.20430107526881722,-6,9,3,0.918918918918919,3.125,34,100,-0.4467005076142132,-6.0,3.0,54.19796954314721,2,68,1,32.0,1.0,32.0,0.918918918918919,1
460,Carla Suarez Navarro,Shelby Rogers,460,2,0,67,38,33,14,63,41,37,14,0.3958333333333333,0.2692307692307692,0.3225806451612903,4,-3,0,1.0634920634920635,3.0303030303030303,52,100,-0.4467005076142132,4.0,0.0,54.19796954314721,2,67,1,33.0,0.0,33.0,1.0634920634920635,0
461,Madison Keys,Monica Puig,461,2,1,52,26,48,21,61,31,39,11,0.7083333333333334,0.40384615384615385,0.34408602150537637,-9,-5,10,0.8524590163934426,2.0833333333333335,47,100,-0.4467005076142132,-9.0,10.0,54.19796954314721,2,52,1,48.0,1.0,48.0,0.8524590163934426,0
462,Ana Ivanovic,Mathilde Johansson,462,2,0,73,17,27,4,55,20,45,10,0.2708333333333333,0.07692307692307693,0.40860215053763443,18,-3,-6,1.3272727272727274,3.7037037037037037,21,100,-0.4467005076142132,18.0,-6.0,54.19796954314721,2,73,1,27.0,0.0,27.0,1.3272727272727274,0
463,Virginie Razzano,Zuzana Kucova,463,2,0,72,36,28,10,72,42,28,14,0.2916666666666667,0.19230769230769232,0.22580645161290322,0,-6,-4,1.0,3.5714285714285716,46,100,-0.4467005076142132,0.0,-4.0,54.19796954314721,2,72,1,28.0,0.0,28.0,1.0,0
464,Urszula Radwanska,Dinah Pfizenmaier,464,2,1,60,24,40,15,67,20,33,9,0.5416666666666666,0.28846153846153844,0.27956989247311825,-7,4,6,0.8955223880597015,2.5,39,100,-0.4467005076142132,-7.0,6.0,54.19796954314721,2,60,1,40.0,1.0,40.0,0.8955223880597015,1
465,Mallory Burdette,Agnieszka Radwanska,465,2,1,65,23,35,11,73,17,27,5,0.4375,0.21153846153846154,0.21505376344086022,-8,6,6,0.8904109589041096,2.857142857142857,34,100,-0.4467005076142132,-8.0,6.0,54.19796954314721,2,65,1,34.5,1.0,35.0,0.8904109589041096,1
466,Angelique Kerber,Jana Cepelova,466,2,0,70,12,30,3,62,24,38,11,0.3333333333333333,0.057692307692307696,0.3333333333333333,8,-12,-8,1.1290322580645162,3.3333333333333335,15,100,-0.4467005076142132,8.0,-8.0,54.19796954314721,2,70,1,30.0,0.0,30.0,1.1290322580645162,0
467,Elina Svitolina,Varvara Lepchenko,467,2,1,61,23,39,12,65,22,35,10,0.5208333333333334,0.23076923076923078,0.3010752688172043,-4,1,2,0.9384615384615385,2.5641025641025643,35,100,-0.4467005076142132,-4.0,2.0,54.19796954314721,2,61,1,38.0,1.0,39.0,0.9384615384615385,1
468,Svetlana Kuznetsova,Magdalena Rybarikova,468,2,0,66,32,34,11,79,36,21,7,0.4166666666666667,0.21153846153846154,0.15053763440860216,-13,-4,4,0.8354430379746836,2.9411764705882355,43,100,-0.4467005076142132,-13.0,4.0,54.19796954314721,2,66,1,34.0,0.0,34.0,0.8354430379746836,0
469,Bojana Jovanovski,Caroline Wozniacki,469,2,0,70,29,30,10,68,34,32,8,0.3333333333333333,0.19230769230769232,0.26881720430107525,2,-5,2,1.0294117647058822,3.3333333333333335,39,100,-0.4467005076142132,2.0,2.0,54.19796954314721,2,70,1,30.0,0.0,30.0,1.0294117647058822,0
470,Roberta Vinci,Galina Voskoboeva,470,2,0,60,36,40,11,56,35,44,18,0.5416666666666666,0.21153846153846154,0.3978494623655914,4,1,-7,1.0714285714285714,2.5,47,100,-0.4467005076142132,4.0,-7.0,54.19796954314721,2,60,1,40.0,0.0,40.0,1.0714285714285714,1
471,Petra Cetkovska,Anastasia Pavlyuchenkova,471,2,0,50,33,50,22,54,29,46,20,0.75,0.4230769230769231,0.41935483870967744,-4,4,2,0.9259259259259259,2.0,55,100,-0.4467005076142132,-4.0,2.0,54.19796954314721,2,50,1,50.0,0.0,50.0,0.9259259259259259,1
472,Sorana Cirstea,Johanna Larsson,472,2,0,63,12,37,9,54,27,46,14,0.4791666666666667,0.17307692307692307,0.41935483870967744,9,-15,-5,1.1666666666666667,2.7027027027027026,21,100,-0.4467005076142132,9.0,-5.0,54.19796954314721,2,63,1,37.0,0.0,37.0,1.1666666666666667,0
473,Caroline Garcia,Serena Williams,473,2,1,69,23,31,9,53,16,47,9,0.3541666666666667,0.17307692307692307,0.43010752688172044,16,7,0,1.3018867924528301,3.225806451612903,32,100,-0.4467005076142132,16.0,0.0,54.19796954314721,2,69,1,32.5,1.0,31.0,1.3018867924528301,1
474,Maria Sharapova,Jie Zheng,474,3,0,81,23,19,3,57,22,43,13,0.10416666666666667,0.057692307692307696,0.3870967741935484,24,1,-10,1.4210526315789473,5.2631578947368425,26,100,0.037383177570093455,24.0,-10.0,50.467289719626166,3,81,1,27.5,0.0,19.0,1.4210526315789473,1
475,Sloane Stephens,Marina Erakovic,475,3,0,64,37,36,15,78,58,22,11,0.4583333333333333,0.28846153846153844,0.16129032258064516,-14,-21,4,0.8205128205128205,2.7777777777777777,52,100,0.037383177570093455,-14.0,4.0,50.467289719626166,3,64,1,36.0,0.0,36.0,0.8205128205128205,0
476,Samantha Stosur,Jelena Jankovic,476,3,1,73,39,27,13,70,35,30,16,0.2708333333333333,0.25,0.24731182795698925,3,4,-3,1.042857142857143,3.7037037037037037,52,100,0.037383177570093455,3.0,-3.0,50.467289719626166,3,73,1,32.5,1.0,27.0,1.042857142857143,1
477,Jamie Hampton,Petra Kvitova,477,3,0,63,24,37,10,51,24,49,12,0.4791666666666667,0.19230769230769232,0.45161290322580644,12,0,-2,1.2352941176470589,2.7027027027027026,34,100,0.037383177570093455,12.0,-2.0,50.467289719626166,3,63,1,37.0,0.0,37.0,1.2352941176470589,0
478,Victoria Azarenka,Alize Cornet,478,3,0,65,28,35,10,69,40,31,11,0.4375,0.19230769230769232,0.25806451612903225,-4,-12,-1,0.9420289855072463,2.857142857142857,38,100,0.037383177570093455,-4.0,-1.0,50.467289719626166,3,65,1,35.0,0.0,35.0,0.9420289855072463,0
479,Francesca Schiavone,Marion Bartoli,479,3,0,62,14,38,8,53,17,47,15,0.5,0.15384615384615385,0.43010752688172044,9,-3,-7,1.169811320754717,2.6315789473684212,22,100,0.037383177570093455,9.0,-7.0,50.467289719626166,3,62,1,38.0,0.0,38.0,1.169811320754717,0
480,Maria Kirilenko,Stefanie Voegele,480,3,0,52,30,48,19,57,27,43,20,0.7083333333333334,0.36538461538461536,0.3870967741935484,-5,3,-1,0.9122807017543859,2.0833333333333335,49,100,0.037383177570093455,-5.0,-1.0,50.467289719626166,3,52,1,48.0,0.0,48.0,0.9122807017543859,1
481,Paula Ormaechea,Bethanie Mattek-Sands,481,3,1,71,34,29,12,55,32,45,8,0.3125,0.23076923076923078,0.40860215053763443,16,2,4,1.290909090909091,3.4482758620689653,46,100,0.037383177570093455,16.0,4.0,50.467289719626166,3,71,1,29.0,1.0,29.0,1.290909090909091,1
482,Sara Errani,Sabine Lisicki,482,3,0,46,15,54,7,89,34,11,2,0.8333333333333334,0.1346153846153846,0.043010752688172046,-43,-19,5,0.5168539325842697,1.8518518518518519,22,100,0.037383177570093455,-43.0,5.0,50.467289719626166,3,46,1,54.0,0.0,54.0,0.5168539325842697,0
483,Carla Suarez Navarro,Monica Puig,483,3,0,59,24,41,12,72,39,28,8,0.5625,0.23076923076923078,0.22580645161290322,-13,-15,4,0.8194444444444444,2.4390243902439024,36,100,0.037383177570093455,-13.0,4.0,50.467289719626166,3,59,1,41.0,0.0,41.0,0.8194444444444444,0
484,Ana Ivanovic,Virginie Razzano,484,3,0,70,18,30,7,73,32,27,8,0.3333333333333333,0.1346153846153846,0.21505376344086022,-3,-14,-1,0.958904109589041,3.3333333333333335,25,100,0.037383177570093455,-3.0,-1.0,50.467289719626166,3,70,1,30.0,0.0,30.0,0.958904109589041,0
485,Dinah Pfizenmaier,Agnieszka Radwanska,485,3,1,61,26,39,16,62,24,38,12,0.5208333333333334,0.3076923076923077,0.3333333333333333,-1,2,4,0.9838709677419355,2.5641025641025643,42,100,0.037383177570093455,-1.0,4.0,50.467289719626166,3,61,1,37.0,1.0,39.0,0.9838709677419355,1
486,Angelique Kerber,Varvara Lepchenko,486,3,0,81,54,19,6,65,47,35,19,0.10416666666666667,0.11538461538461539,0.3010752688172043,16,7,-13,1.2461538461538462,5.2631578947368425,60,100,0.037383177570093455,16.0,-13.0,50.467289719626166,3,81,1,19.0,0.0,19.0,1.2461538461538462,1
487,Svetlana Kuznetsova,Bojana Jovanovski,487,3,0,69,31,31,10,67,29,33,11,0.3541666666666667,0.19230769230769232,0.27956989247311825,2,2,-1,1.0298507462686568,3.225806451612903,41,100,0.037383177570093455,2.0,-1.0,50.467289719626166,3,69,1,31.0,0.0,31.0,1.0298507462686568,1
488,Roberta Vinci,Petra Cetkovska,488,3,0,63,26,37,11,62,32,38,18,0.4791666666666667,0.21153846153846154,0.3333333333333333,1,-6,-7,1.0161290322580645,2.7027027027027026,37,100,0.037383177570093455,1.0,-7.0,50.467289719626166,3,63,1,37.0,0.0,37.0,1.0161290322580645,0
489,Sorana Cirstea,Serena Williams,489,3,1,67,22,33,10,56,13,44,6,0.3958333333333333,0.19230769230769232,0.3978494623655914,11,9,4,1.1964285714285714,3.0303030303030303,32,100,0.037383177570093455,11.0,4.0,50.467289719626166,3,67,1,42.5,1.0,33.0,1.1964285714285714,1
490,Maria Sharapova,Sloane Stephens,490,4,0,65,28,35,12,63,25,37,12,0.4375,0.23076923076923078,0.3225806451612903,2,3,0,1.0317460317460319,2.857142857142857,40,100,0.38181818181818183,2.0,0.0,55.54545454545455,4,65,1,31.5,0.0,35.0,1.0317460317460319,1
491,Jelena Jankovic,Jamie Hampton,491,4,0,66,11,34,7,70,22,30,8,0.4166666666666667,0.1346153846153846,0.24731182795698925,-4,-11,-1,0.9428571428571428,2.9411764705882355,18,100,0.38181818181818183,-4.0,-1.0,55.54545454545455,4,66,1,34.0,0.0,34.0,0.9428571428571428,0
492,Victoria Azarenka,Francesca Schiavone,492,4,0,57,11,43,3,88,28,12,3,0.6041666666666666,0.057692307692307696,0.053763440860215055,-31,-17,0,0.6477272727272727,2.3255813953488373,14,100,0.38181818181818183,-31.0,0.0,55.54545454545455,4,57,1,43.0,0.0,43.0,0.6477272727272727,0
493,Maria Kirilenko,Bethanie Mattek-Sands,493,4,0,56,29,44,18,64,31,36,14,0.625,0.34615384615384615,0.3118279569892473,-8,-2,4,0.875,2.272727272727273,47,100,0.38181818181818183,-8.0,4.0,55.54545454545455,4,56,1,44.0,0.0,44.0,0.875,0
494,Sara Errani,Carla Suarez Navarro,494,4,0,67,32,33,14,91,57,9,4,0.3958333333333333,0.2692307692307692,0.021505376344086023,-24,-25,10,0.7362637362637363,3.0303030303030303,46,100,0.38181818181818183,-24.0,10.0,55.54545454545455,4,67,1,33.0,0.0,33.0,0.7362637362637363,0
495,Ana Ivanovic,Agnieszka Radwanska,495,4,1,57,21,43,15,50,19,50,15,0.6041666666666666,0.28846153846153844,0.46236559139784944,7,2,0,1.14,2.3255813953488373,36,100,0.38181818181818183,7.0,0.0,55.54545454545455,4,57,1,35.0,1.0,43.0,1.14,1
496,Angelique Kerber,Svetlana Kuznetsova,496,4,1,63,46,37,17,75,44,25,13,0.4791666666666667,0.3269230769230769,0.1935483870967742,-12,2,4,0.84,2.7027027027027026,63,100,0.38181818181818183,-12.0,4.0,55.54545454545455,4,63,1,37.0,1.0,37.0,0.84,1
497,Roberta Vinci,Serena Williams,497,4,1,62,24,38,12,68,20,32,9,0.5,0.23076923076923078,0.26881720430107525,-6,4,3,0.9117647058823529,2.6315789473684212,36,100,0.38181818181818183,-6.0,3.0,55.54545454545455,4,62,1,36.0,1.0,38.0,0.9117647058823529,1
498,Maria Sharapova,Jelena Jankovic,498,5,0,63,31,37,16,66,30,34,13,0.4791666666666667,0.3076923076923077,0.2903225806451613,-3,1,3,0.9545454545454546,2.7027027027027026,47,100,-1.2222222222222223,-3.0,3.0,54.333333333333336,5,63,1,37.0,0.0,37.0,0.9545454545454546,1
499,Victoria Azarenka,Maria Kirilenko,499,5,0,57,31,43,8,78,32,22,4,0.6041666666666666,0.15384615384615385,0.16129032258064516,-21,-1,4,0.7307692307692307,2.3255813953488373,39,100,-1.2222222222222223,-21.0,4.0,54.333333333333336,5,57,1,43.0,0.0,43.0,0.7307692307692307,0
500,Sara Errani,Agnieszka Radwanska,500,5,0,70,28,30,5,84,41,16,3,0.3333333333333333,0.09615384615384616,0.0967741935483871,-14,-13,2,0.8333333333333334,3.3333333333333335,33,100,-1.2222222222222223,-14.0,2.0,54.333333333333336,5,70,1,35.5,0.0,30.0,0.8333333333333334,0
501,Svetlana Kuznetsova,Serena Williams,501,5,1,66,42,34,12,77,28,23,7,0.4166666666666667,0.23076923076923078,0.17204301075268819,-11,14,5,0.8571428571428571,2.9411764705882355,54,100,-1.2222222222222223,-11.0,5.0,54.333333333333336,5,66,1,34.0,1.0,34.0,0.8571428571428571,1
502,Maria Sharapova,Victoria Azarenka,502,6,0,72,28,28,8,62,41,38,10,0.2916666666666667,0.15384615384615385,0.3333333333333333,10,-13,-2,1.1612903225806452,3.5714285714285716,36,100,-3.2857142857142856,10.0,-2.0,57.357142857142854,6,72,1,28.0,0.0,28.0,1.1612903225806452,0
503,Sara Errani,Serena Williams,503,6,1,52,14,48,14,80,10,20,1,0.7083333333333334,0.2692307692307692,0.13978494623655913,-28,4,13,0.65,2.0833333333333335,28,100,-3.2857142857142856,-28.0,13.0,57.357142857142854,6,52,1,48.0,1.0,48.0,0.65,1
504,Maria Sharapova,Serena Williams,504,7,1,69,27,31,8,55,20,45,20,0.3541666666666667,0.15384615384615385,0.40860215053763443,14,7,-12,1.2545454545454546,3.225806451612903,35,100,5.285714285714286,14.0,-12.0,47.857142857142854,7,69,1,31.0,1.0,31.0,1.2545454545454546,1
505,Michael Russell,Richard Gasquet,505,1,1,63,45,37,16,59,37,41,17,0.4791666666666667,0.3076923076923077,0.3655913978494624,4,8,-1,1.0677966101694916,2.7027027027027026,61,100,0.5652985074626866,4.0,-1.0,57.115671641791046,1,63,1,38.833333333333336,1.0,37.0,1.0677966101694916,1
506,Albano Olivetti,Stephane Robert,506,1,1,61,44,39,19,56,37,44,15,0.5208333333333334,0.36538461538461536,0.3978494623655914,5,7,4,1.0892857142857142,2.5641025641025643,63,100,0.5652985074626866,5.0,4.0,57.115671641791046,1,61,1,46.5,1.0,39.0,1.0892857142857142,1
507,Guillaume Rufin,Jan-Lennard Struff,507,1,0,55,61,45,32,55,66,45,27,0.6458333333333334,0.6153846153846154,0.40860215053763443,0,-5,5,1.0,2.2222222222222223,93,100,0.5652985074626866,0.0,5.0,57.115671641791046,1,55,1,48.5,0.0,45.0,1.0,0
508,Dmitry Tursunov,Aljaz Bedene,508,1,0,52,41,48,19,55,52,45,27,0.7083333333333334,0.36538461538461536,0.40860215053763443,-3,-11,-8,0.9454545454545454,2.0833333333333335,60,100,0.5652985074626866,-3.0,-8.0,57.115671641791046,1,52,1,48.0,0.0,48.0,0.9454545454545454,0
509,Florent Serra,Feliciano Lopez,509,1,1,58,54,42,30,61,63,39,30,0.5833333333333334,0.5769230769230769,0.34408602150537637,-3,-9,0,0.9508196721311475,2.380952380952381,84,100,0.5652985074626866,-3.0,0.0,57.115671641791046,1,58,1,43.666666666666664,1.0,42.0,0.9508196721311475,0
510,Bradley Klahn,Kenny De Schepper,510,1,0,59,68,41,37,71,72,29,26,0.5625,0.7115384615384616,0.23655913978494625,-12,-4,11,0.8309859154929577,2.4390243902439024,105,100,0.5652985074626866,-12.0,11.0,57.115671641791046,1,59,1,38.5,0.0,41.0,0.8309859154929577,0
511,Dudi Sela,Andrey Kuznetsov,511,1,0,53,59,47,44,59,65,41,38,0.6875,0.8461538461538461,0.3655913978494624,-6,-6,6,0.8983050847457628,2.127659574468085,103,100,0.5652985074626866,-6.0,6.0,57.115671641791046,1,53,1,38.0,0.0,47.0,0.8983050847457628,0
512,Janko Tipsarevic,Pablo Cuevas,512,1,0,51,39,49,24,55,42,45,28,0.7291666666666666,0.46153846153846156,0.40860215053763443,-4,-3,-4,0.9272727272727272,2.0408163265306123,63,100,0.5652985074626866,-4.0,-4.0,57.115671641791046,1,51,1,49.0,0.0,49.0,0.9272727272727272,0
513,Andreas Haider-Maurer,Ernests Gulbis,513,1,0,58,68,42,31,49,58,51,43,0.5833333333333334,0.5961538461538461,0.4731182795698925,9,10,-12,1.183673469387755,2.380952380952381,99,100,0.5652985074626866,9.0,-12.0,57.115671641791046,1,58,1,44.5,0.0,42.0,1.183673469387755,1
514,Andrej Martin,Mikhail Kukushkin,514,1,1,51,35,49,27,49,35,51,20,0.7291666666666666,0.5192307692307693,0.4731182795698925,2,0,7,1.0408163265306123,2.0408163265306123,62,100,0.5652985074626866,2.0,7.0,57.115671641791046,1,51,1,49.0,1.0,49.0,1.0408163265306123,0
515,Thomaz Bellucci,Roberto Bautista Agut,515,1,1,75,44,25,12,57,28,43,10,0.22916666666666666,0.23076923076923078,0.3870967741935484,18,16,2,1.3157894736842106,4.0,56,100,0.5652985074626866,18.0,2.0,57.115671641791046,1,75,1,24.5,1.0,25.0,1.3157894736842106,1
516,David Ferrer,Nick Kyrgios,516,1,0,69,44,31,9,55,40,45,21,0.3541666666666667,0.17307692307692307,0.40860215053763443,14,4,-12,1.2545454545454546,3.225806451612903,53,100,0.5652985074626866,14.0,-12.0,57.115671641791046,1,69,1,38.5,0.0,31.0,1.2545454545454546,1
517,Marinko Matosevic,Tommy Robredo,517,1,1,54,49,46,30,59,44,41,27,0.6666666666666666,0.5769230769230769,0.3655913978494624,-5,5,3,0.9152542372881356,2.1739130434782608,79,100,0.5652985074626866,-5.0,3.0,57.115671641791046,1,54,1,42.6,1.0,46.0,0.9152542372881356,1
518,Frank Dancevic,Robin Haase,518,1,0,58,65,42,34,64,68,36,34,0.5833333333333334,0.6538461538461539,0.3118279569892473,-6,-3,0,0.90625,2.380952380952381,99,100,0.5652985074626866,-6.0,0.0,57.115671641791046,1,58,1,37.5,0.0,42.0,0.90625,0
519,Bernard Tomic,Albert Ramos,519,1,0,55,76,45,42,68,71,32,28,0.6458333333333334,0.8076923076923077,0.26881720430107525,-13,5,14,0.8088235294117647,2.2222222222222223,118,100,0.5652985074626866,-13.0,14.0,57.115671641791046,1,55,1,41.0,0.0,45.0,0.8088235294117647,1
520,Kei Nishikori,Daniel Evans,520,1,1,48,35,52,25,54,30,46,15,0.7916666666666666,0.4807692307692308,0.41935483870967744,-6,5,10,0.8888888888888888,1.9230769230769231,60,100,0.5652985074626866,-6.0,10.0,57.115671641791046,1,48,1,52.0,1.0,52.0,0.8888888888888888,1
521,Ivan Dodig,Fernando Verdasco,521,1,0,59,58,41,23,57,60,43,34,0.5625,0.4423076923076923,0.3870967741935484,2,-2,-11,1.0350877192982457,2.4390243902439024,81,100,0.5652985074626866,2.0,-11.0,57.115671641791046,1,59,1,38.666666666666664,0.0,41.0,1.0350877192982457,0
522,Nikolay Davydenko,Rhyne Williams,522,1,0,55,56,45,26,57,57,43,28,0.6458333333333334,0.5,0.3870967741935484,-2,-1,-2,0.9649122807017544,2.2222222222222223,82,100,0.5652985074626866,-2.0,-2.0,57.115671641791046,1,55,1,44.0,0.0,45.0,0.9649122807017544,0
523,Rafael Nadal,Ryan Harrison,523,1,0,62,41,38,10,72,42,28,11,0.5,0.19230769230769232,0.22580645161290322,-10,-1,-1,0.8611111111111112,2.6315789473684212,51,100,0.5652985074626866,-10.0,-1.0,57.115671641791046,1,62,1,38.0,0.0,38.0,0.8611111111111112,0
524,Ricardas Berankis,Novak Djokovic,524,1,1,68,36,32,14,53,18,47,9,0.375,0.2692307692307692,0.43010752688172044,15,18,5,1.2830188679245282,3.125,50,100,0.5652985074626866,15.0,5.0,57.115671641791046,1,68,1,31.142857142857142,1.0,32.0,1.2830188679245282,1
525,Lukas Rosol,Benjamin Becker,525,1,1,52,38,48,27,47,44,53,27,0.7083333333333334,0.5192307692307693,0.4946236559139785,5,-6,0,1.1063829787234043,2.0833333333333335,65,100,0.5652985074626866,5.0,0.0,57.115671641791046,1,52,1,41.0,1.0,48.0,1.1063829787234043,0
526,Jarkko Nieminen,Lukasz Kubot,526,1,0,38,28,62,27,59,38,41,19,1.0,0.5192307692307693,0.3655913978494624,-21,-10,8,0.6440677966101694,1.6129032258064515,55,100,0.5652985074626866,-21.0,8.0,57.115671641791046,1,38,1,49.0,0.0,62.0,0.6440677966101694,0
527,Grigor Dimitrov,Joao Sousa,527,1,1,58,61,42,27,58,53,42,27,0.5833333333333334,0.5192307692307693,0.3763440860215054,0,8,0,1.0,2.380952380952381,88,100,0.5652985074626866,0.0,0.0,57.115671641791046,1,58,1,36.0,1.0,42.0,1.0,1
528,Paul-Henri Mathieu,Tommy Haas,528,1,1,59,38,41,15,56,29,44,16,0.5625,0.28846153846153844,0.3978494623655914,3,9,-1,1.0535714285714286,2.4390243902439024,53,100,0.5652985074626866,3.0,-1.0,57.115671641791046,1,59,1,41.5,1.0,41.0,1.0535714285714286,1
529,Daniel Gimeno-Traver,Yen-Hsun Lu,529,1,1,67,49,33,19,56,45,44,22,0.3958333333333333,0.36538461538461536,0.3978494623655914,11,4,-3,1.1964285714285714,3.0303030303030303,68,100,0.5652985074626866,11.0,-3.0,57.115671641791046,1,67,1,33.0,1.0,33.0,1.1964285714285714,1
530,Martin Klizan,Donald Young,530,1,1,74,39,26,10,47,10,53,10,0.25,0.19230769230769232,0.4946236559139785,27,29,0,1.574468085106383,3.8461538461538463,49,100,0.5652985074626866,27.0,0.0,57.115671641791046,1,74,1,32.0,1.0,26.0,1.574468085106383,1
531,Juan Monaco,Florian Mayer,531,1,1,65,34,35,15,63,20,37,11,0.4375,0.28846153846153844,0.3225806451612903,2,14,4,1.0317460317460319,2.857142857142857,49,100,0.5652985074626866,2.0,4.0,57.115671641791046,1,65,1,39.333333333333336,1.0,35.0,1.0317460317460319,1
532,Steve Johnson,Tobias Kamke,532,1,1,53,55,47,39,48,56,52,40,0.6875,0.75,0.4838709677419355,5,-1,-1,1.1041666666666667,2.127659574468085,94,100,0.5652985074626866,5.0,-1.0,57.115671641791046,1,53,1,47.5,1.0,47.0,1.1041666666666667,0
533,Nicolas Almagro,Denis Istomin,533,1,1,64,50,36,23,64,36,36,14,0.4583333333333333,0.4423076923076923,0.3118279569892473,0,14,9,1.0,2.7777777777777777,73,100,0.5652985074626866,0.0,9.0,57.115671641791046,1,64,1,36.0,1.0,36.0,1.0,1
534,Michal Przysiezny,Julien Benneteau,534,1,1,61,49,39,25,58,52,42,27,0.5208333333333334,0.4807692307692308,0.3763440860215054,3,-3,-2,1.0517241379310345,2.5641025641025643,74,100,0.5652985074626866,3.0,-2.0,57.115671641791046,1,61,1,39.25,1.0,39.0,1.0517241379310345,0
535,Jeremy Chardy,Sergiy Stakhovsky,535,1,0,53,62,47,33,56,64,44,40,0.6875,0.6346153846153846,0.3978494623655914,-3,-2,-7,0.9464285714285714,2.127659574468085,95,100,0.5652985074626866,-3.0,-7.0,57.115671641791046,1,53,1,46.0,0.0,47.0,0.9464285714285714,0
536,Denis Kudla,Jiri Vesely,536,1,0,55,50,45,30,63,56,37,27,0.6458333333333334,0.5769230769230769,0.3225806451612903,-8,-6,3,0.873015873015873,2.2222222222222223,80,100,0.5652985074626866,-8.0,3.0,57.115671641791046,1,55,1,42.0,0.0,45.0,0.873015873015873,0
537,Tomas Berdych,Paolo Lorenzi,537,1,0,48,27,52,11,56,34,44,12,0.7916666666666666,0.21153846153846154,0.3978494623655914,-8,-7,-1,0.8571428571428571,1.9230769230769231,38,100,0.5652985074626866,-8.0,-1.0,57.115671641791046,1,48,1,52.0,0.0,52.0,0.8571428571428571,0
538,Thiemo de Bakker,Pablo Andujar,538,1,1,60,44,40,19,52,33,48,19,0.5416666666666666,0.36538461538461536,0.44086021505376344,8,11,0,1.1538461538461537,2.5,63,100,0.5652985074626866,8.0,0.0,57.115671641791046,1,60,1,38.0,1.0,40.0,1.1538461538461537,1
539,Milos Raonic,Thomas Fabbiano,539,1,0,66,46,34,17,63,51,37,19,0.4166666666666667,0.3269230769230769,0.3225806451612903,3,-5,-2,1.0476190476190477,2.9411764705882355,63,100,0.5652985074626866,3.0,-2.0,57.115671641791046,1,66,1,34.0,0.0,34.0,1.0476190476190477,0
540,Maximo Gonzalez,Jerzy Janowicz,540,1,0,58,40,42,17,65,45,35,13,0.5833333333333334,0.3269230769230769,0.3010752688172043,-7,-5,4,0.8923076923076924,2.380952380952381,57,100,0.5652985074626866,-7.0,4.0,57.115671641791046,1,58,1,42.0,0.0,42.0,0.8923076923076924,0
541,Philipp Petzschner,Jack Sock,541,1,1,51,36,49,29,46,29,54,27,0.7291666666666666,0.5576923076923077,0.5053763440860215,5,7,2,1.108695652173913,2.0408163265306123,65,100,0.5652985074626866,5.0,2.0,57.115671641791046,1,51,1,49.0,1.0,49.0,1.108695652173913,1
542,Grega Zemlja,Roger Federer,542,1,1,60,41,40,21,49,29,51,18,0.5416666666666666,0.40384615384615385,0.4731182795698925,11,12,3,1.2244897959183674,2.5,62,100,0.5652985074626866,11.0,3.0,57.115671641791046,1,60,1,42.75,1.0,40.0,1.2244897959183674,1
543,Carlos Berlocq,Santiago Giraldo,543,1,0,58,63,42,30,64,61,36,30,0.5833333333333334,0.5769230769230769,0.3118279569892473,-6,2,0,0.90625,2.380952380952381,93,100,0.5652985074626866,-6.0,0.0,57.115671641791046,1,58,1,38.5,0.0,42.0,0.90625,1
544,Adrian Mannarino,Horacio Zeballos,544,1,0,52,44,48,29,57,47,43,30,0.7083333333333334,0.5576923076923077,0.3870967741935484,-5,-3,-1,0.9122807017543859,2.0833333333333335,73,100,0.5652985074626866,-5.0,-1.0,57.115671641791046,1,52,1,48.0,0.0,48.0,0.9122807017543859,0
545,Sam Querrey,Guido Pella,545,1,0,56,54,44,31,58,60,42,26,0.625,0.5961538461538461,0.3763440860215054,-2,-6,5,0.9655172413793104,2.272727272727273,85,100,0.5652985074626866,-2.0,5.0,57.115671641791046,1,56,1,44.0,0.0,44.0,0.9655172413793104,0
546,Filippo Volandri,John Isner,546,1,1,73,42,27,11,56,18,44,10,0.2708333333333333,0.21153846153846154,0.3978494623655914,17,24,1,1.3035714285714286,3.7037037037037037,53,100,0.5652985074626866,17.0,1.0,57.115671641791046,1,73,1,27.666666666666668,1.0,27.0,1.3035714285714286,1
547,Gael Monfils,Adrian Ungur,547,1,0,56,18,44,8,84,33,16,4,0.625,0.15384615384615385,0.0967741935483871,-28,-15,4,0.6666666666666666,2.272727272727273,26,100,0.5652985074626866,-28.0,4.0,57.115671641791046,1,56,1,44.0,0.0,44.0,0.6666666666666666,0
548,Edouard Roger-Vasselin,Albert Montanes,548,1,0,51,29,49,20,64,38,36,18,0.7291666666666666,0.38461538461538464,0.3118279569892473,-13,-9,2,0.796875,2.0408163265306123,49,100,0.5652985074626866,-13.0,2.0,57.115671641791046,1,51,1,49.0,0.0,49.0,0.796875,0
549,Philipp Kohlschreiber,Collin Altamirano,549,1,0,58,27,42,8,58,31,42,16,0.5833333333333334,0.15384615384615385,0.3763440860215054,0,-4,-8,1.0,2.380952380952381,35,100,0.5652985074626866,0.0,-8.0,57.115671641791046,1,58,1,42.0,0.0,42.0,1.0,0
550,Vasek Pospisil,Rogerio Dutra Silva,550,1,1,58,64,42,39,48,66,52,46,0.5833333333333334,0.75,0.4838709677419355,10,-2,-7,1.2083333333333333,2.380952380952381,103,100,0.5652985074626866,10.0,-7.0,57.115671641791046,1,58,1,42.0,1.0,42.0,1.2083333333333333,0
551,Alex Bogomolov Jr.,Benoit Paire,551,1,0,51,72,49,40,64,82,36,33,0.7291666666666666,0.7692307692307693,0.3118279569892473,-13,-10,7,0.796875,2.0408163265306123,112,100,0.5652985074626866,-13.0,7.0,57.115671641791046,1,51,1,48.666666666666664,0.0,49.0,0.796875,0
552,James Duckworth,Tim Smyczek,552,1,1,66,47,34,21,55,47,45,26,0.4166666666666667,0.40384615384615385,0.40860215053763443,11,0,-5,1.2,2.9411764705882355,68,100,0.5652985074626866,11.0,-5.0,57.115671641791046,1,66,1,36.5,1.0,34.0,1.2,0
553,Marcel Granollers,Jurgen Zopp,553,1,0,51,46,49,27,52,43,48,27,0.7291666666666666,0.5192307692307693,0.44086021505376344,-1,3,0,0.9807692307692307,2.0408163265306123,73,100,0.5652985074626866,-1.0,0.0,57.115671641791046,1,51,1,40.5,0.0,49.0,0.9807692307692307,1
554,Fabio Fognini,Rajeev Ram,554,1,1,73,40,27,10,54,21,46,13,0.2708333333333333,0.19230769230769232,0.41935483870967744,19,19,-3,1.3518518518518519,3.7037037037037037,50,100,0.5652985074626866,19.0,-3.0,57.115671641791046,1,73,1,27.0,1.0,27.0,1.3518518518518519,1
555,Alexandr Dolgopolov,David Goffin,555,1,0,67,44,33,14,45,34,55,27,0.3958333333333333,0.2692307692307692,0.5161290322580645,22,10,-13,1.488888888888889,3.0303030303030303,58,100,0.5652985074626866,22.0,-13.0,57.115671641791046,1,67,1,33.0,0.0,33.0,1.488888888888889,1
556,Mikhail Youzhny,Nicolas Mahut,556,1,0,63,50,37,22,64,50,36,20,0.4791666666666667,0.4230769230769231,0.3118279569892473,-1,0,2,0.984375,2.7027027027027026,72,100,0.5652985074626866,-1.0,2.0,57.115671641791046,1,63,1,36.5,0.0,37.0,0.984375,0
557,Evgeny Donskoy,Jurgen Melzer,557,1,0,65,39,35,17,57,48,43,27,0.4375,0.3269230769230769,0.3870967741935484,8,-9,-10,1.1403508771929824,2.857142857142857,56,100,0.5652985074626866,8.0,-10.0,57.115671641791046,1,65,1,35.0,0.0,35.0,1.1403508771929824,0
558,Peter Gojowczyk,Igor Sijsling,558,1,0,55,49,45,24,51,40,49,29,0.6458333333333334,0.46153846153846156,0.45161290322580644,4,9,-5,1.0784313725490196,2.2222222222222223,73,100,0.5652985074626866,4.0,-5.0,57.115671641791046,1,55,1,40.5,0.0,45.0,1.0784313725490196,1
559,Brian Baker,Lleyton Hewitt,559,1,1,46,38,54,29,49,32,51,28,0.8333333333333334,0.5576923076923077,0.4731182795698925,-3,6,1,0.9387755102040817,1.8518518518518519,67,100,0.5652985074626866,-3.0,1.0,57.115671641791046,1,46,1,52.0,1.0,54.0,0.9387755102040817,1
560,Juan Martin Del Potro,Guillermo Garcia-Lopez,560,1,0,48,57,52,45,62,62,38,31,0.7916666666666666,0.8653846153846154,0.3333333333333333,-14,-5,14,0.7741935483870968,1.9230769230769231,102,100,0.5652985074626866,-14.0,14.0,57.115671641791046,1,48,1,47.0,0.0,52.0,0.7741935483870968,0
561,Michael Llodra,Andy Murray,561,1,1,67,36,33,15,63,31,37,12,0.3958333333333333,0.28846153846153844,0.3225806451612903,4,5,3,1.0634920634920635,3.0303030303030303,51,100,0.5652985074626866,4.0,3.0,57.115671641791046,1,67,1,38.333333333333336,1.0,33.0,1.0634920634920635,1
562,Leonardo Mayer,Victor Hanescu,562,1,0,67,72,33,29,57,60,43,37,0.3958333333333333,0.5576923076923077,0.3870967741935484,10,12,-8,1.1754385964912282,3.0303030303030303,101,100,0.5652985074626866,10.0,-8.0,57.115671641791046,1,67,1,33.0,0.0,33.0,1.1754385964912282,1
563,Xavier Malisse,Andreas Seppi,563,1,1,59,62,41,24,46,41,54,36,0.5625,0.46153846153846156,0.5053763440860215,13,21,-12,1.2826086956521738,2.4390243902439024,86,100,0.5652985074626866,13.0,-12.0,57.115671641791046,1,59,1,40.4,1.0,41.0,1.2826086956521738,1
564,Somdev Devvarman,Lukas Lacko,564,1,0,50,48,50,29,56,60,44,31,0.75,0.5576923076923077,0.3978494623655914,-6,-12,-2,0.8928571428571429,2.0,77,100,0.5652985074626866,-6.0,-2.0,57.115671641791046,1,50,1,45.666666666666664,0.0,50.0,0.8928571428571429,0
565,Radek Stepanek,Stanislas Wawrinka,565,1,1,51,32,49,27,66,37,34,16,0.7291666666666666,0.5192307692307693,0.2903225806451613,-15,-5,11,0.7727272727272727,2.0408163265306123,59,100,0.5652985074626866,-15.0,11.0,57.115671641791046,1,51,1,41.166666666666664,1.0,49.0,0.7727272727272727,0
566,Ivo Karlovic,James Blake,566,1,0,64,82,36,36,63,90,37,29,0.4583333333333333,0.6923076923076923,0.3225806451612903,1,-8,7,1.0158730158730158,2.7777777777777777,118,100,0.5652985074626866,1.0,7.0,57.115671641791046,1,64,1,36.0,0.0,36.0,1.0158730158730158,0
567,Go Soeda,Marcos Baghdatis,567,1,1,60,34,40,20,54,30,46,15,0.5416666666666666,0.38461538461538464,0.41935483870967744,6,4,5,1.1111111111111112,2.5,54,100,0.5652985074626866,6.0,5.0,57.115671641791046,1,60,1,48.333333333333336,1.0,40.0,1.1111111111111112,1
568,Kevin Anderson,Daniel Brands,568,1,0,59,58,41,20,53,50,47,35,0.5625,0.38461538461538464,0.43010752688172044,6,8,-15,1.1132075471698113,2.4390243902439024,78,100,0.5652985074626866,6.0,-15.0,57.115671641791046,1,59,1,39.0,0.0,41.0,1.1132075471698113,1
569,Stephane Robert,Richard Gasquet,569,1,1,58,50,42,22,53,35,47,19,0.5833333333333334,0.4230769230769231,0.43010752688172044,5,15,3,1.0943396226415094,2.380952380952381,72,100,0.5652985074626866,5.0,3.0,57.115671641791046,1,58,1,38.833333333333336,1.0,42.0,1.0943396226415094,1
570,Dmitry Tursunov,Guillaume Rufin,570,1,0,43,14,57,12,58,24,42,13,0.8958333333333334,0.23076923076923078,0.3763440860215054,-15,-10,-1,0.7413793103448276,1.7543859649122806,26,100,0.5652985074626866,-15.0,-1.0,57.115671641791046,1,43,1,57.0,0.0,57.0,0.7413793103448276,0
571,Bradley Klahn,Feliciano Lopez,571,1,1,52,59,48,38,71,69,29,18,0.7083333333333334,0.7307692307692307,0.23655913978494625,-19,-10,20,0.7323943661971831,2.0833333333333335,97,100,0.5652985074626866,-19.0,20.0,57.115671641791046,1,52,1,43.666666666666664,1.0,48.0,0.7323943661971831,0
572,Milos Raonic,Pablo Andujar,572,1,0,64,32,36,17,63,44,37,12,0.4583333333333333,0.3269230769230769,0.3225806451612903,1,-12,5,1.0158730158730158,2.7777777777777777,49,100,0.5652985074626866,1.0,5.0,57.115671641791046,1,64,1,38.0,0.0,36.0,1.0158730158730158,0
573,Jack Sock,Maximo Gonzalez,573,1,0,68,51,32,17,62,54,38,25,0.375,0.3269230769230769,0.3333333333333333,6,-3,-8,1.096774193548387,3.125,68,100,0.5652985074626866,6.0,-8.0,57.115671641791046,1,68,1,32.0,0.0,32.0,1.096774193548387,0
574,Janko Tipsarevic,Dudi Sela,574,1,0,62,30,38,10,44,32,56,31,0.5,0.19230769230769232,0.5268817204301075,18,-2,-21,1.4090909090909092,2.6315789473684212,40,100,0.5652985074626866,18.0,-21.0,57.115671641791046,1,62,1,35.0,0.0,38.0,1.4090909090909092,0
575,Mikhail Kukushkin,Andreas Haider-Maurer,575,1,0,60,45,40,17,57,42,43,29,0.5416666666666666,0.3269230769230769,0.3870967741935484,3,3,-12,1.0526315789473684,2.5,62,100,0.5652985074626866,3.0,-12.0,57.115671641791046,1,60,1,37.5,0.0,40.0,1.0526315789473684,1
576,David Ferrer,Roberto Bautista Agut,576,1,0,62,42,38,20,59,48,41,29,0.5,0.38461538461538464,0.3655913978494624,3,-6,-9,1.0508474576271187,2.6315789473684212,62,100,0.5652985074626866,3.0,-9.0,57.115671641791046,1,62,1,24.5,0.0,38.0,1.0508474576271187,0
577,Carlos Berlocq,Roger Federer,577,1,1,52,27,48,22,84,36,16,2,0.7083333333333334,0.4230769230769231,0.0967741935483871,-32,-9,20,0.6190476190476191,2.0833333333333335,49,100,0.5652985074626866,-32.0,20.0,57.115671641791046,1,52,1,42.75,1.0,48.0,0.6190476190476191,0
578,Sam Querrey,Adrian Mannarino,578,1,1,55,68,45,41,58,77,42,34,0.6458333333333334,0.7884615384615384,0.3763440860215054,-3,-9,7,0.9482758620689655,2.2222222222222223,109,100,0.5652985074626866,-3.0,7.0,57.115671641791046,1,55,1,41.0,1.0,45.0,0.9482758620689655,0
579,Frank Dancevic,Tommy Robredo,579,1,1,64,39,36,12,65,34,35,10,0.4583333333333333,0.23076923076923078,0.3010752688172043,-1,5,2,0.9846153846153847,2.7777777777777777,51,100,0.5652985074626866,-1.0,2.0,57.115671641791046,1,64,1,42.6,1.0,36.0,0.9846153846153847,1
580,Daniel Evans,Bernard Tomic,580,1,0,62,47,38,23,56,43,44,27,0.5,0.4423076923076923,0.3978494623655914,6,4,-4,1.1071428571428572,2.6315789473684212,70,100,0.5652985074626866,6.0,-4.0,57.115671641791046,1,62,1,37.5,0.0,38.0,1.1071428571428572,1
581,Gael Monfils,John Isner,581,1,1,70,71,30,21,83,74,17,11,0.3333333333333333,0.40384615384615385,0.10752688172043011,-13,-3,10,0.8433734939759037,3.3333333333333335,92,100,0.5652985074626866,-13.0,10.0,57.115671641791046,1,70,1,27.666666666666668,1.0,30.0,0.8433734939759037,0
582,Philipp Kohlschreiber,Edouard Roger-Vasselin,582,1,0,61,48,39,25,58,44,42,26,0.5208333333333334,0.4807692307692308,0.3763440860215054,3,4,-1,1.0517241379310345,2.5641025641025643,73,100,0.5652985074626866,3.0,-1.0,57.115671641791046,1,61,1,39.0,0.0,39.0,1.0517241379310345,1
583,Nikolay Davydenko,Ivan Dodig,583,1,1,66,45,34,14,51,25,49,18,0.4166666666666667,0.2692307692307692,0.45161290322580644,15,20,-4,1.2941176470588236,2.9411764705882355,59,100,0.5652985074626866,15.0,-4.0,57.115671641791046,1,66,1,42.0,1.0,34.0,1.2941176470588236,1
584,Rafael Nadal,Rogerio Dutra Silva,584,1,0,58,21,42,12,69,30,31,11,0.5833333333333334,0.23076923076923078,0.25806451612903225,-11,-9,1,0.8405797101449275,2.380952380952381,33,100,0.5652985074626866,-11.0,1.0,57.115671641791046,1,58,1,42.0,0.0,42.0,0.8405797101449275,0
585,Benjamin Becker,Novak Djokovic,585,1,1,74,48,26,11,59,33,41,19,0.25,0.21153846153846154,0.3655913978494624,15,15,-8,1.2542372881355932,3.8461538461538463,59,100,0.5652985074626866,15.0,-8.0,57.115671641791046,1,74,1,31.142857142857142,1.0,26.0,1.2542372881355932,1
586,Joao Sousa,Jarkko Nieminen,586,1,0,64,65,36,25,63,66,37,23,0.4583333333333333,0.4807692307692308,0.3225806451612903,1,-1,2,1.0158730158730158,2.7777777777777777,90,100,0.5652985074626866,1.0,2.0,57.115671641791046,1,64,1,33.5,0.0,36.0,1.0158730158730158,0
587,Tim Smyczek,Alex Bogomolov Jr.,587,1,0,69,87,31,30,63,73,37,26,0.3541666666666667,0.5769230769230769,0.3225806451612903,6,14,4,1.0952380952380953,3.225806451612903,117,100,0.5652985074626866,6.0,4.0,57.115671641791046,1,69,1,31.0,0.0,31.0,1.0952380952380953,1
588,Rajeev Ram,Marcel Granollers,588,1,1,62,63,38,28,66,66,34,22,0.5,0.5384615384615384,0.2903225806451613,-4,-3,6,0.9393939393939394,2.6315789473684212,91,100,0.5652985074626866,-4.0,6.0,57.115671641791046,1,62,1,34.0,1.0,38.0,0.9393939393939394,0
589,Yen-Hsun Lu,Tommy Haas,589,1,1,60,51,40,20,68,44,32,13,0.5416666666666666,0.38461538461538464,0.26881720430107525,-8,7,7,0.8823529411764706,2.5,71,100,0.5652985074626866,-8.0,7.0,57.115671641791046,1,60,1,41.5,1.0,40.0,0.8823529411764706,1
590,Mikhail Youzhny,Alexandr Dolgopolov,590,1,0,53,35,47,19,52,33,48,23,0.6875,0.36538461538461536,0.44086021505376344,1,2,-4,1.0192307692307692,2.127659574468085,54,100,0.5652985074626866,1.0,-4.0,57.115671641791046,1,53,1,46.0,0.0,47.0,1.0192307692307692,1
591,Peter Gojowczyk,Evgeny Donskoy,591,1,1,55,63,45,34,55,67,45,30,0.6458333333333334,0.6538461538461539,0.40860215053763443,0,-4,4,1.0,2.2222222222222223,97,100,0.5652985074626866,0.0,4.0,57.115671641791046,1,55,1,43.5,1.0,45.0,1.0,0
592,Juan Martin Del Potro,Lleyton Hewitt,592,1,1,50,56,50,38,57,57,43,39,0.75,0.7307692307692307,0.3870967741935484,-7,-1,-1,0.8771929824561403,2.0,94,100,0.5652985074626866,-7.0,-1.0,57.115671641791046,1,50,1,52.0,1.0,50.0,0.8771929824561403,0
593,Leonardo Mayer,Andy Murray,593,1,1,57,41,43,35,63,40,37,16,0.6041666666666666,0.6730769230769231,0.3225806451612903,-6,1,19,0.9047619047619048,2.3255813953488373,76,100,0.5652985074626866,-6.0,19.0,57.115671641791046,1,57,1,38.333333333333336,1.0,43.0,0.9047619047619048,1
594,Florian Mayer,Donald Young,594,1,0,62,42,38,20,57,48,43,21,0.5,0.38461538461538464,0.3870967741935484,5,-6,-1,1.087719298245614,2.6315789473684212,62,100,0.5652985074626866,5.0,-1.0,57.115671641791046,1,62,1,32.0,0.0,38.0,1.087719298245614,0
595,Somdev Devvarman,Andreas Seppi,595,1,1,52,48,48,27,56,41,44,24,0.7083333333333334,0.5192307692307693,0.3978494623655914,-4,7,3,0.9285714285714286,2.0833333333333335,75,100,0.5652985074626866,-4.0,3.0,57.115671641791046,1,52,1,40.4,1.0,48.0,0.9285714285714286,1
596,Denis Istomin,Tobias Kamke,596,1,0,46,19,54,23,46,24,54,21,0.8333333333333334,0.4423076923076923,0.5053763440860215,0,-5,2,1.0,1.8518518518518519,42,100,0.5652985074626866,0.0,2.0,57.115671641791046,1,46,1,47.5,0.0,54.0,1.0,0
597,Ivo Karlovic,Stanislas Wawrinka,597,1,1,60,51,40,25,63,52,37,21,0.5416666666666666,0.4807692307692308,0.3225806451612903,-3,-1,4,0.9523809523809523,2.5,76,100,0.5652985074626866,-3.0,4.0,57.115671641791046,1,60,1,41.166666666666664,1.0,40.0,0.9523809523809523,0
598,Kevin Anderson,Marcos Baghdatis,598,1,1,43,24,57,24,64,27,36,11,0.8958333333333334,0.46153846153846156,0.3118279569892473,-21,-3,13,0.671875,1.7543859649122806,48,100,0.5652985074626866,-21.0,13.0,57.115671641791046,1,43,1,48.333333333333336,1.0,57.0,0.671875,0
599,Jeremy Chardy,Julien Benneteau,599,1,1,58,39,42,18,57,29,43,13,0.5833333333333334,0.34615384615384615,0.3870967741935484,1,10,5,1.0175438596491229,2.380952380952381,57,100,0.5652985074626866,1.0,5.0,57.115671641791046,1,58,1,39.25,1.0,42.0,1.0175438596491229,1
600,Tomas Berdych,Denis Kudla,600,1,0,60,49,40,26,57,49,43,28,0.5416666666666666,0.5,0.3870967741935484,3,0,-2,1.0526315789473684,2.5,75,100,0.5652985074626866,3.0,-2.0,57.115671641791046,1,60,1,40.0,0.0,40.0,1.0526315789473684,0
601,Dmitry Tursunov,Richard Gasquet,601,1,1,64,42,36,21,53,46,47,24,0.4583333333333333,0.40384615384615385,0.43010752688172044,11,-4,-3,1.2075471698113207,2.7777777777777777,63,100,0.5652985074626866,11.0,-3.0,57.115671641791046,1,64,1,38.833333333333336,1.0,36.0,1.2075471698113207,0
602,Milos Raonic,Feliciano Lopez,602,1,0,59,56,41,29,67,66,33,19,0.5625,0.5576923076923077,0.27956989247311825,-8,-10,10,0.8805970149253731,2.4390243902439024,85,100,0.5652985074626866,-8.0,10.0,57.115671641791046,1,59,1,43.666666666666664,0.0,41.0,0.8805970149253731,0
603,Janko Tipsarevic,Jack Sock,603,1,0,46,35,54,27,56,46,44,33,0.8333333333333334,0.5192307692307693,0.3978494623655914,-10,-11,-6,0.8214285714285714,1.8518518518518519,62,100,0.5652985074626866,-10.0,-6.0,57.115671641791046,1,46,1,49.0,0.0,54.0,0.8214285714285714,0
604,David Ferrer,Mikhail Kukushkin,604,1,0,51,50,49,27,60,47,40,20,0.7291666666666666,0.5192307692307693,0.3548387096774194,-9,3,7,0.85,2.0408163265306123,77,100,0.5652985074626866,-9.0,7.0,57.115671641791046,1,51,1,49.0,0.0,49.0,0.85,1
605,Adrian Mannarino,Roger Federer,605,1,1,57,36,43,15,65,27,35,9,0.6041666666666666,0.28846153846153844,0.3010752688172043,-8,9,6,0.8769230769230769,2.3255813953488373,51,100,0.5652985074626866,-8.0,6.0,57.115671641791046,1,57,1,42.75,1.0,43.0,0.8769230769230769,1
606,Daniel Evans,Tommy Robredo,606,1,1,60,58,40,25,62,65,38,23,0.5416666666666666,0.4807692307692308,0.3333333333333333,-2,-7,2,0.967741935483871,2.5,83,100,0.5652985074626866,-2.0,2.0,57.115671641791046,1,60,1,42.6,1.0,40.0,0.967741935483871,0
607,Philipp Kohlschreiber,John Isner,607,1,0,74,72,26,14,73,73,27,20,0.25,0.2692307692307692,0.21505376344086022,1,-1,-6,1.0136986301369864,3.8461538461538463,86,100,0.5652985074626866,1.0,-6.0,57.115671641791046,1,74,1,27.666666666666668,0.0,26.0,1.0136986301369864,0
608,Rafael Nadal,Ivan Dodig,608,1,0,52,28,48,18,65,41,35,20,0.7083333333333334,0.34615384615384615,0.3010752688172043,-13,-13,-2,0.8,2.0833333333333335,46,100,0.5652985074626866,-13.0,-2.0,57.115671641791046,1,52,1,42.0,0.0,48.0,0.8,0
609,Joao Sousa,Novak Djokovic,609,1,1,68,30,32,12,59,30,41,10,0.375,0.23076923076923078,0.3655913978494624,9,0,2,1.152542372881356,3.125,42,100,0.5652985074626866,9.0,2.0,57.115671641791046,1,68,1,31.142857142857142,1.0,32.0,1.152542372881356,0
610,Marcel Granollers,Tim Smyczek,610,1,0,61,63,39,26,59,66,41,28,0.5208333333333334,0.5,0.3655913978494624,2,-3,-2,1.0338983050847457,2.5641025641025643,89,100,0.5652985074626866,2.0,-2.0,57.115671641791046,1,61,1,36.5,0.0,39.0,1.0338983050847457,0
611,Mikhail Youzhny,Tommy Haas,611,1,0,50,37,50,22,57,43,43,21,0.75,0.4230769230769231,0.3870967741935484,-7,-6,1,0.8771929824561403,2.0,59,100,0.5652985074626866,-4.5,1.5,57.115671641791046,4,61,2,41.5,0.5,50.0,0.8771929824561403,0
612,Lleyton Hewitt,Evgeny Donskoy,612,1,0,58,55,42,17,52,49,48,37,0.5833333333333334,0.3269230769230769,0.44086021505376344,6,6,-20,1.1153846153846154,2.380952380952381,72,100,0.5652985074626866,6.0,-20.0,57.115671641791046,1,58,1,43.5,0.0,42.0,1.1153846153846154,1
613,Florian Mayer,Andy Murray,613,1,1,51,37,49,25,62,40,38,15,0.7291666666666666,0.4807692307692308,0.3333333333333333,-11,-3,10,0.8225806451612904,2.0408163265306123,62,100,0.5652985074626866,-11.0,10.0,57.115671641791046,1,51,1,38.333333333333336,1.0,49.0,0.8225806451612904,0
614,Denis Istomin,Andreas Seppi,614,1,0,61,55,39,23,65,65,35,23,0.5208333333333334,0.4423076923076923,0.3010752688172043,-4,-10,0,0.9384615384615385,2.5641025641025643,78,100,0.5652985074626866,-4.0,0.0,57.115671641791046,1,61,1,40.4,0.0,39.0,0.9384615384615385,0
615,Marcos Baghdatis,Stanislas Wawrinka,615,1,1,52,55,48,37,47,50,53,43,0.7083333333333334,0.7115384615384616,0.4946236559139785,5,5,-6,1.1063829787234043,2.0833333333333335,92,100,0.5652985074626866,5.0,-6.0,57.115671641791046,1,52,1,41.166666666666664,1.0,48.0,1.1063829787234043,1
616,Tomas Berdych,Julien Benneteau,616,1,0,52,25,48,12,58,39,42,14,0.7083333333333334,0.23076923076923078,0.3763440860215054,-6,-14,-2,0.896551724137931,2.0833333333333335,37,100,0.5652985074626866,-6.0,-2.0,57.115671641791046,1,52,1,39.25,0.0,48.0,0.896551724137931,0
617,Milos Raonic,Richard Gasquet,617,1,1,59,81,41,45,56,83,44,46,0.5625,0.8653846153846154,0.3978494623655914,3,-2,-1,1.0535714285714286,2.4390243902439024,126,100,0.5652985074626866,3.0,-1.0,57.115671641791046,1,59,1,38.833333333333336,1.0,41.0,1.0535714285714286,0
618,David Ferrer,Janko Tipsarevic,618,1,0,59,68,41,34,65,68,35,23,0.5625,0.6538461538461539,0.3010752688172043,-6,0,11,0.9076923076923077,2.4390243902439024,102,100,0.5652985074626866,-6.0,11.0,57.115671641791046,1,59,1,41.0,0.0,41.0,0.9076923076923077,0
619,Tommy Robredo,Roger Federer,619,1,0,60,38,40,16,70,61,30,17,0.5416666666666666,0.3076923076923077,0.24731182795698925,-10,-23,-1,0.8571428571428571,2.5,54,100,0.5652985074626866,-10.0,-1.0,57.115671641791046,1,60,1,42.75,0.0,40.0,0.8571428571428571,0
620,Rafael Nadal,Philipp Kohlschreiber,620,1,0,63,58,37,26,66,54,34,26,0.4791666666666667,0.5,0.2903225806451613,-3,4,0,0.9545454545454546,2.7027027027027026,84,100,0.5652985074626866,-3.0,0.0,57.115671641791046,1,63,1,37.0,0.0,37.0,0.9545454545454546,1
621,Lleyton Hewitt,Mikhail Youzhny,621,1,1,59,55,41,29,52,48,48,37,0.5625,0.5576923076923077,0.44086021505376344,7,7,-8,1.1346153846153846,2.4390243902439024,84,100,0.5652985074626866,7.0,-8.0,57.115671641791046,1,59,1,35.666666666666664,1.0,41.0,1.1346153846153846,1
622,Denis Istomin,Andy Murray,622,1,1,63,58,37,23,69,55,31,20,0.4791666666666667,0.4423076923076923,0.25806451612903225,-6,3,3,0.9130434782608695,2.7027027027027026,81,100,0.5652985074626866,-6.0,3.0,57.115671641791046,1,63,1,38.333333333333336,1.0,37.0,0.9130434782608695,1
623,Tomas Berdych,Stanislas Wawrinka,623,1,1,58,55,42,27,58,51,42,19,0.5833333333333334,0.5192307692307693,0.3763440860215054,0,4,8,1.0,2.380952380952381,82,100,0.5652985074626866,0.0,8.0,57.115671641791046,1,58,1,41.166666666666664,1.0,42.0,1.0,1
624,David Ferrer,Richard Gasquet,624,1,1,59,57,41,31,63,53,37,29,0.5625,0.5961538461538461,0.3225806451612903,-4,4,2,0.9365079365079365,2.4390243902439024,88,100,0.5652985074626866,-4.0,2.0,57.115671641791046,1,59,1,38.833333333333336,1.0,41.0,0.9365079365079365,1
625,Rafael Nadal,Tommy Robredo,625,1,0,52,20,48,9,61,31,39,14,0.7083333333333334,0.17307692307692307,0.34408602150537637,-9,-11,-5,0.8524590163934426,2.0833333333333335,29,100,0.5652985074626866,-9.0,-5.0,57.115671641791046,1,52,1,42.6,0.0,48.0,0.8524590163934426,0
626,Mikhail Youzhny,Novak Djokovic,626,1,1,68,49,32,19,56,29,44,23,0.375,0.36538461538461536,0.3978494623655914,12,20,-4,1.2142857142857142,3.125,68,100,0.5652985074626866,12.0,-4.0,57.115671641791046,1,68,1,31.142857142857142,1.0,32.0,1.2142857142857142,1
627,Stanislas Wawrinka,Andy Murray,627,1,0,63,37,37,22,55,37,45,20,0.4791666666666667,0.4230769230769231,0.40860215053763443,8,0,2,1.1454545454545455,2.7027027027027026,59,100,0.5652985074626866,8.0,2.0,57.115671641791046,1,63,1,38.333333333333336,0.0,37.0,1.1454545454545455,0
628,Stanislas Wawrinka,Novak Djokovic,628,1,1,67,64,33,25,50,68,50,48,0.3958333333333333,0.4807692307692308,0.46236559139784944,17,-4,-23,1.34,3.0303030303030303,89,100,0.5652985074626866,17.0,-23.0,57.115671641791046,1,67,1,31.142857142857142,1.0,33.0,1.34,0
629,Rafael Nadal,Richard Gasquet,629,1,0,64,41,36,15,71,51,29,16,0.4583333333333333,0.28846153846153844,0.23655913978494625,-7,-10,-1,0.9014084507042254,2.7777777777777777,56,100,0.5652985074626866,-7.0,-1.0,57.115671641791046,1,64,1,38.833333333333336,0.0,36.0,0.9014084507042254,0
630,Rafael Nadal,Novak Djokovic,630,1,0,68,40,32,16,64,51,36,24,0.375,0.3076923076923077,0.3118279569892473,4,-11,-8,1.0625,3.125,56,100,0.5652985074626866,3.5,-6.5,57.115671641791046,6,68,2,31.142857142857142,0.0,32.0,1.0625,0
631,V Azarenka,S Williams,631,7,1,57,44,43,20,57,31,43,23,0.6041666666666666,0.38461538461538464,0.3870967741935484,0,13,-3,1.0,2.3255813953488373,64,100,5.285714285714286,0.0,-3.0,47.857142857142854,7,57,1,43.0,1.0,43.0,1.0,1
632,V Azarenka,F Pennetta,632,6,0,44,12,56,7,56,21,44,10,0.875,0.1346153846153846,0.3978494623655914,-12,-9,-3,0.7857142857142857,1.7857142857142858,19,100,-3.2857142857142856,-12.0,-3.0,57.357142857142854,6,44,1,56.0,0.0,56.0,0.7857142857142857,0
633,N Li,S Williams,633,6,1,63,26,37,9,63,20,37,10,0.4791666666666667,0.17307692307692307,0.3225806451612903,0,6,-1,1.0,2.7027027027027026,35,100,-3.2857142857142856,0.0,-1.0,57.357142857142854,6,63,1,37.0,1.0,37.0,1.0,1
634,F Pennetta,R Vinci,634,5,0,60,21,40,7,63,23,37,8,0.5416666666666666,0.1346153846153846,0.3225806451612903,-3,-2,-1,0.9523809523809523,2.5,28,100,-1.2222222222222223,-3.0,-1.0,54.333333333333336,5,60,1,40.0,0.0,40.0,0.9523809523809523,0
635,V Azarenka,D Hantuchova,635,5,0,58,14,42,5,60,20,40,9,0.5833333333333334,0.09615384615384616,0.3548387096774194,-2,-6,-4,0.9666666666666667,2.380952380952381,19,100,-1.2222222222222223,-2.0,-4.0,54.333333333333336,5,58,1,42.0,0.0,42.0,0.9666666666666667,0
636,N Li,E Makarova,636,5,0,60,40,40,18,68,43,32,14,0.5416666666666666,0.34615384615384615,0.26881720430107525,-8,-3,4,0.8823529411764706,2.5,58,100,-1.2222222222222223,-8.0,4.0,54.333333333333336,5,60,1,40.0,0.0,40.0,0.8823529411764706,0
637,V Azarenka,A Ivanovic,637,4,0,55,26,45,18,73,40,27,7,0.6458333333333334,0.34615384615384615,0.21505376344086022,-18,-14,11,0.7534246575342466,2.2222222222222223,44,100,0.38181818181818183,-18.0,11.0,55.54545454545455,4,55,1,45.0,0.0,45.0,0.7534246575342466,0
638,D Hantuchova,A Riske,638,4,0,69,37,31,14,60,38,40,19,0.3541666666666667,0.2692307692307692,0.3548387096774194,9,-1,-5,1.15,3.225806451612903,51,100,0.38181818181818183,9.0,-5.0,55.54545454545455,4,69,1,31.0,0.0,31.0,1.15,0
639,F Pennetta,S Halep,639,4,0,75,22,25,8,45,23,55,16,0.22916666666666666,0.15384615384615385,0.5161290322580645,30,-1,-8,1.6666666666666667,4.0,30,100,0.38181818181818183,30.0,-8.0,55.54545454545455,4,75,1,25.0,0.0,25.0,1.6666666666666667,0
640,R Vinci,C Giorgi,640,4,0,54,18,46,11,54,19,46,15,0.6666666666666666,0.21153846153846154,0.41935483870967744,0,-1,-4,1.0,2.1739130434782608,29,100,0.38181818181818183,0.0,-4.0,55.54545454545455,4,54,1,46.0,0.0,46.0,1.0,0
641,S Stephens,S Williams,641,4,1,62,26,38,11,66,28,34,8,0.5,0.21153846153846154,0.2903225806451613,-4,-2,3,0.9393939393939394,2.6315789473684212,37,100,0.38181818181818183,-4.0,3.0,55.54545454545455,4,62,1,38.0,1.0,38.0,0.9393939393939394,0
642,N Li,J Jankovic,642,4,0,66,8,34,3,58,17,42,8,0.4166666666666667,0.057692307692307696,0.3763440860215054,8,-9,-5,1.1379310344827587,2.9411764705882355,11,100,0.38181818181818183,8.0,-5.0,55.54545454545455,4,66,1,34.0,0.0,34.0,1.1379310344827587,0
643,A Kerber,C Suarez Navarro,643,4,1,78,54,22,9,68,47,32,12,0.16666666666666666,0.17307692307692307,0.26881720430107525,10,7,-3,1.1470588235294117,4.545454545454546,63,100,0.38181818181818183,10.0,-3.0,55.54545454545455,4,78,1,22.0,1.0,22.0,1.1470588235294117,1
644,C McHale,A Ivanovic,644,3,1,60,41,40,18,64,39,36,14,0.5416666666666666,0.34615384615384615,0.3118279569892473,-4,2,4,0.9375,2.5,59,100,0.037383177570093455,-4.0,4.0,50.467289719626166,3,60,1,40.0,1.0,40.0,0.9375,1
645,C Giorgi,C Wozniack,645,3,0,62,34,38,21,63,47,37,22,0.5,0.40384615384615385,0.3225806451612903,-1,-13,-1,0.9841269841269841,2.6315789473684212,55,100,0.037383177570093455,-1.0,-1.0,50.467289719626166,3,62,1,38.0,0.0,38.0,0.9841269841269841,0
646,S Halep,M Kirilenko,646,3,0,54,9,46,5,81,23,19,3,0.6666666666666666,0.09615384615384616,0.12903225806451613,-27,-14,2,0.6666666666666666,2.1739130434782608,14,100,0.037383177570093455,-27.0,2.0,50.467289719626166,3,54,1,46.0,0.0,46.0,0.6666666666666666,0
647,V Azarenka,A Cornet,647,3,0,56,44,44,21,68,48,32,17,0.625,0.40384615384615385,0.26881720430107525,-12,-4,4,0.8235294117647058,2.272727272727273,65,100,0.037383177570093455,-12.0,4.0,50.467289719626166,3,56,1,44.0,0.0,44.0,0.8235294117647058,0
648,R Vinci,K Knapp,648,3,0,58,22,42,8,51,25,49,16,0.5833333333333334,0.15384615384615385,0.45161290322580644,7,-3,-8,1.1372549019607843,2.380952380952381,30,100,0.037383177570093455,7.0,-8.0,50.467289719626166,3,58,1,42.0,0.0,42.0,1.1372549019607843,0
649,A Riske,P Kvitova,649,3,0,52,18,48,10,70,22,30,6,0.7083333333333334,0.19230769230769232,0.24731182795698925,-18,-4,4,0.7428571428571429,2.0833333333333335,28,100,0.037383177570093455,-18.0,4.0,50.467289719626166,3,52,1,48.0,0.0,48.0,0.7428571428571429,0
650,F Pennetta,S Kuznetsova,650,3,0,55,21,45,10,51,26,49,17,0.6458333333333334,0.19230769230769232,0.45161290322580644,4,-5,-7,1.0784313725490196,2.2222222222222223,31,100,0.037383177570093455,4.0,-7.0,50.467289719626166,3,55,1,45.0,0.0,45.0,1.0784313725490196,0
651,D Hantuchova,J Glushko,651,3,0,73,43,27,10,61,41,39,21,0.2708333333333333,0.19230769230769232,0.34408602150537637,12,2,-11,1.1967213114754098,3.7037037037037037,53,100,0.037383177570093455,12.0,-11.0,50.467289719626166,3,73,1,27.0,0.0,27.0,1.1967213114754098,1
652,N Li,L Robson,652,3,0,52,16,48,16,65,29,35,10,0.7083333333333334,0.3076923076923077,0.3010752688172043,-13,-13,6,0.8,2.0833333333333335,32,100,0.037383177570093455,-13.0,6.0,50.467289719626166,3,52,1,48.0,0.0,48.0,0.8,0
653,S Stephens,J Hampton,653,3,0,55,14,45,6,70,25,30,8,0.6458333333333334,0.11538461538461539,0.24731182795698925,-15,-11,-2,0.7857142857142857,2.2222222222222223,20,100,0.037383177570093455,-15.0,-2.0,50.467289719626166,3,55,1,45.0,0.0,45.0,0.7857142857142857,0
654,Y Shvedova,S Williams,654,3,1,66,28,44,7,59,14,41,12,0.625,0.1346153846153846,0.3655913978494624,7,14,-5,1.11864406779661,2.5,35,110,0.037383177570093455,7.0,-5.0,50.467289719626166,3,66,1,44.0,1.0,44.0,1.11864406779661,1
655,A Pavlyuchenkova,A.Radwanska,655,3,1,75,42,25,12,53,30,47,13,0.22916666666666666,0.23076923076923078,0.43010752688172044,22,12,-1,1.4150943396226414,4.0,54,100,0.037383177570093455,22.0,-1.0,50.467289719626166,3,75,1,27.0,1.0,25.0,1.4150943396226414,1
656,S Lisicki,E Makarova,656,3,1,61,36,39,15,56,28,44,12,0.5208333333333334,0.28846153846153844,0.3978494623655914,5,8,3,1.0892857142857142,2.5641025641025643,51,100,0.037383177570093455,5.0,3.0,50.467289719626166,3,61,1,39.0,1.0,39.0,1.0892857142857142,1
657,C Suarez Navarro,J Zheng,657,3,0,75,27,25,6,79,30,21,5,0.22916666666666666,0.11538461538461539,0.15053763440860216,-4,-3,1,0.9493670886075949,4.0,33,100,0.037383177570093455,-4.0,1.0,50.467289719626166,3,75,1,25.0,0.0,25.0,0.9493670886075949,0
658,K Nara,J Jankovic,658,3,1,52,31,48,12,81,30,19,5,0.7083333333333334,0.23076923076923078,0.12903225806451613,-29,1,7,0.6419753086419753,2.0833333333333335,43,100,0.037383177570093455,-29.0,7.0,50.467289719626166,3,52,1,48.0,1.0,48.0,0.6419753086419753,1
659,A Kerber,K Kanepi,659,3,0,44,17,56,10,44,17,56,14,0.875,0.19230769230769232,0.5268817204301075,0,0,-4,1.0,1.7857142857142858,27,100,0.037383177570093455,0.0,-4.0,50.467289719626166,3,44,1,56.0,0.0,56.0,1.0,0
660,S Errani,F Pennetta,660,2,1,58,24,42,11,93,16,7,1,0.5833333333333334,0.21153846153846154,0.0,-35,8,10,0.6236559139784946,2.380952380952381,35,100,-0.4467005076142132,-35.0,10.0,54.19796954314721,2,58,1,42.0,1.0,42.0,0.6236559139784946,1
661,G Voskoboeva,S Williams,661,2,1,64,21,36,11,57,16,43,7,0.4583333333333333,0.21153846153846154,0.3870967741935484,7,5,4,1.1228070175438596,2.7777777777777777,32,100,-0.4467005076142132,7.0,4.0,54.19796954314721,2,64,1,36.0,1.0,36.0,1.1228070175438596,1
662,C Scheepers,C Wozniacki,662,2,1,76,22,34,6,55,12,45,5,0.4166666666666667,0.11538461538461539,0.40860215053763443,21,10,1,1.3818181818181818,3.235294117647059,28,110,-0.4467005076142132,21.0,1.0,54.19796954314721,2,76,1,34.0,1.0,34.0,1.3818181818181818,1
663,A Kerber,E Bouchard,663,2,0,47,27,53,27,68,34,32,14,0.8125,0.5192307692307693,0.26881720430107525,-21,-7,13,0.6911764705882353,1.8867924528301887,54,100,-0.4467005076142132,-21.0,13.0,54.19796954314721,2,47,1,53.0,0.0,53.0,0.6911764705882353,0
664,V Azarenka,A Wozniak,664,2,0,48,10,52,4,65,25,35,8,0.7916666666666666,0.07692307692307693,0.3010752688172043,-17,-15,-4,0.7384615384615385,1.9230769230769231,14,100,-0.4467005076142132,-17.0,-4.0,54.19796954314721,2,48,1,52.0,0.0,52.0,0.7384615384615385,0
665,E Svitolina,C McHale,665,2,1,66,52,34,21,59,44,41,20,0.4166666666666667,0.40384615384615385,0.3655913978494624,7,8,1,1.11864406779661,2.9411764705882355,73,100,-0.4467005076142132,7.0,1.0,54.19796954314721,2,66,1,34.0,1.0,34.0,1.11864406779661,1
666,A Dulgheru,A Ivanovic,666,2,1,64,39,36,12,79,33,21,5,0.4583333333333333,0.23076923076923078,0.15053763440860216,-15,6,7,0.810126582278481,2.7777777777777777,51,100,-0.4467005076142132,-15.0,7.0,54.19796954314721,2,64,1,36.0,1.0,36.0,0.810126582278481,1
667,S Lisicki,P Ormaechea,667,2,0,41,9,59,15,42,24,58,15,0.9375,0.28846153846153844,0.5483870967741935,-1,-15,0,0.9761904761904762,1.694915254237288,24,100,-0.4467005076142132,-1.0,0.0,54.19796954314721,2,41,1,59.0,0.0,59.0,0.9761904761904762,0
668,A Tomljanovic,A Cornet,668,2,1,56,28,44,12,55,13,45,9,0.625,0.23076923076923078,0.40860215053763443,1,15,3,1.018181818181818,2.272727272727273,40,100,-0.4467005076142132,1.0,3.0,54.19796954314721,2,56,1,44.0,1.0,44.0,1.018181818181818,1
669,V Duval,D Hantuchova,669,2,1,46,14,54,18,74,21,26,6,0.8333333333333334,0.34615384615384615,0.20430107526881722,-28,-7,12,0.6216216216216216,1.8518518518518519,32,100,-0.4467005076142132,-28.0,12.0,54.19796954314721,2,46,1,54.0,1.0,54.0,0.6216216216216216,0
670,S Cirstea,K Nara,670,2,1,80,25,20,8,58,19,42,6,0.125,0.15384615384615385,0.3763440860215054,22,6,2,1.3793103448275863,5.0,33,100,-0.4467005076142132,22.0,2.0,54.19796954314721,2,80,1,20.0,1.0,20.0,1.3793103448275863,1
671,M Barthel,A Riske,671,2,1,62,26,38,11,57,21,43,15,0.5,0.21153846153846154,0.3870967741935484,5,5,-4,1.087719298245614,2.6315789473684212,37,100,-0.4467005076142132,5.0,-4.0,54.19796954314721,2,62,1,38.0,1.0,38.0,1.087719298245614,1
672,S Peng,S Kuznetsova,672,2,1,54,39,46,19,71,44,29,14,0.6666666666666666,0.36538461538461536,0.23655913978494625,-17,-5,5,0.7605633802816901,2.1739130434782608,58,100,-0.4467005076142132,-17.0,5.0,54.19796954314721,2,54,1,46.0,1.0,46.0,0.7605633802816901,0
673,N Li,S Arvidsson,673,2,0,67,18,33,8,58,19,42,13,0.3958333333333333,0.15384615384615385,0.3763440860215054,9,-1,-5,1.1551724137931034,3.0303030303030303,26,100,-0.4467005076142132,9.0,-5.0,54.19796954314721,2,67,1,33.0,0.0,33.0,1.1551724137931034,0
674,S Stephens,U Radwanska,674,2,0,67,10,33,7,67,20,33,8,0.3958333333333333,0.1346153846153846,0.27956989247311825,0,-10,-1,1.0,3.0303030303030303,17,100,-0.4467005076142132,0.0,-1.0,54.19796954314721,2,67,1,33.0,0.0,33.0,1.0,0
675,J Zheng,V Williams,675,2,0,52,39,48,26,74,49,26,15,0.7083333333333334,0.5,0.20430107526881722,-22,-10,11,0.7027027027027027,2.0833333333333335,65,100,-0.4467005076142132,-22.0,11.0,54.19796954314721,2,52,1,48.0,0.0,48.0,0.7027027027027027,0
676,K Mladenovic,J Hampton,676,2,1,56,27,44,15,59,30,41,14,0.625,0.28846153846153844,0.3655913978494624,-3,-3,1,0.9491525423728814,2.272727272727273,42,100,-0.4467005076142132,-3.0,1.0,54.19796954314721,2,56,1,44.0,1.0,44.0,0.9491525423728814,0
677,C Suarez Navarro,C Vandeweghe,677,2,0,47,14,53,10,82,27,18,7,0.8125,0.19230769230769232,0.11827956989247312,-35,-13,3,0.573170731707317,1.8867924528301887,24,100,-0.4467005076142132,-35.0,3.0,54.19796954314721,2,47,1,53.0,0.0,53.0,0.573170731707317,0
678,C Garcia,L Robson,678,2,1,59,28,41,17,64,31,36,17,0.5625,0.3269230769230769,0.3118279569892473,-5,-3,0,0.921875,2.4390243902439024,45,100,-0.4467005076142132,-5.0,0.0,54.19796954314721,2,59,1,41.0,1.0,41.0,0.921875,0
679,A Pavlyuchenkova,A Barty,679,2,0,52,13,48,10,55,21,45,11,0.7083333333333334,0.19230769230769232,0.40860215053763443,-3,-8,-1,0.9454545454545454,2.0833333333333335,23,100,-0.4467005076142132,-3.0,-1.0,54.19796954314721,2,52,1,48.0,0.0,48.0,0.9454545454545454,0
680,M Doi,P Kvitova,680,1,1,73,47,27,11,58,21,42,17,0.2708333333333333,0.21153846153846154,0.3763440860215054,15,26,-6,1.2586206896551724,3.7037037037037037,58,100,0.5652985074626866,15.0,-6.0,57.115671641791046,1,73,1,27.0,1.0,27.0,1.2586206896551724,1
681,Y Duan,C Wozniacki,681,1,1,69,28,31,12,65,24,35,8,0.3541666666666667,0.23076923076923078,0.3010752688172043,4,4,4,1.0615384615384615,3.225806451612903,40,100,0.5652985074626866,4.0,4.0,57.115671641791046,1,69,1,31.0,1.0,31.0,1.0615384615384615,1
682,V Azarenka,D Pfizenmaier,682,1,0,67,17,33,4,51,16,49,12,0.3958333333333333,0.07692307692307693,0.45161290322580644,16,1,-8,1.3137254901960784,3.0303030303030303,21,100,0.5652985074626866,16.0,-8.0,57.115671641791046,1,67,1,33.0,0.0,33.0,1.3137254901960784,1
683,S Errani,O Rogowska,683,1,0,47,8,53,4,69,21,31,7,0.8125,0.07692307692307693,0.25806451612903225,-22,-13,-3,0.6811594202898551,1.8867924528301887,12,100,0.5652985074626866,-22.0,-3.0,57.115671641791046,1,47,1,53.0,0.0,53.0,0.6811594202898551,0
684,S Stosur,V Duval,684,1,1,63,49,37,19,63,45,37,17,0.4791666666666667,0.36538461538461536,0.3225806451612903,0,4,2,1.0,2.7027027027027026,68,100,0.5652985074626866,0.0,2.0,57.115671641791046,1,63,1,37.0,1.0,37.0,1.0,1
685,A Tatishvili,A Ivanovic,685,1,1,62,17,48,11,63,13,47,4,0.7083333333333334,0.21153846153846154,0.43010752688172044,-1,4,7,0.9841269841269841,2.2916666666666665,28,110,0.5652985074626866,-1.0,7.0,57.115671641791046,1,62,1,48.0,1.0,48.0,0.9841269841269841,1
686,C McHale,J Goerges,686,1,0,53,32,47,11,58,28,42,13,0.6875,0.21153846153846154,0.3763440860215054,-5,4,-2,0.9137931034482759,2.127659574468085,43,100,0.5652985074626866,-5.0,-2.0,57.115671641791046,1,53,1,47.0,0.0,47.0,0.9137931034482759,1
687,A Dulgheru,V Lepchenko,687,1,0,63,38,37,18,64,51,36,19,0.4791666666666667,0.34615384615384615,0.3118279569892473,-1,-13,-1,0.984375,2.7027027027027026,56,100,0.5652985074626866,-1.0,-1.0,57.115671641791046,1,63,1,37.0,0.0,37.0,0.984375,0
688,M Burdette,S Kuznetsova,688,1,1,63,26,37,12,68,27,32,15,0.4791666666666667,0.23076923076923078,0.26881720430107525,-5,-1,-3,0.9264705882352942,2.7027027027027026,38,100,0.5652985074626866,-5.0,-3.0,57.115671641791046,1,63,1,37.0,1.0,37.0,0.9264705882352942,0
689,A Petkovic,B Jovanovski,689,1,1,60,31,40,15,74,25,26,3,0.5416666666666666,0.28846153846153844,0.20430107526881722,-14,6,12,0.8108108108108109,2.5,46,100,0.5652985074626866,-14.0,12.0,57.115671641791046,1,60,1,40.0,1.0,40.0,0.8108108108108109,1
690,Y Meusburger,S Peng,690,1,1,54,18,46,16,73,24,27,9,0.6666666666666666,0.3076923076923077,0.21505376344086022,-19,-6,7,0.7397260273972602,2.1739130434782608,34,100,0.5652985074626866,-19.0,7.0,57.115671641791046,1,54,1,46.0,1.0,46.0,0.7397260273972602,0
691,M Koehler,A Cornet,691,1,1,53,19,47,18,45,21,55,13,0.6875,0.34615384615384615,0.5161290322580645,8,-2,5,1.1777777777777778,2.127659574468085,37,100,0.5652985074626866,8.0,5.0,57.115671641791046,1,53,1,47.0,1.0,47.0,1.1777777777777778,0
692,S Halep,H Watson,692,1,0,54,29,46,16,73,40,27,7,0.6666666666666666,0.3076923076923077,0.21505376344086022,-19,-11,9,0.7397260273972602,2.1739130434782608,45,100,0.5652985074626866,-19.0,9.0,57.115671641791046,1,54,1,46.0,0.0,46.0,0.7397260273972602,0
693,V Williams,K Flipkens,693,1,0,46,15,54,7,52,24,48,12,0.8333333333333334,0.1346153846153846,0.44086021505376344,-6,-9,-5,0.8846153846153846,1.8518518518518519,22,100,0.5652985074626866,-6.0,-5.0,57.115671641791046,1,46,1,54.0,0.0,54.0,0.8846153846153846,0
694,S.Soler-Espinosa,A.Radwanska,694,1,1,72,26,28,6,50,10,50,10,0.2916666666666667,0.11538461538461539,0.46236559139784944,22,16,-4,1.44,3.5714285714285716,32,100,0.5652985074626866,22.0,-4.0,57.115671641791046,1,72,1,27.5,1.0,28.0,1.44,1
695,F Schiavone,S Williams,695,1,1,51,13,49,12,43,8,57,5,0.7291666666666666,0.23076923076923078,0.5376344086021505,8,5,7,1.186046511627907,2.0408163265306123,25,100,0.5652985074626866,8.0,7.0,57.115671641791046,1,51,1,49.0,1.0,49.0,1.186046511627907,1
696,N Li,O Govortsova,696,1,0,68,22,42,6,62,19,48,13,0.5833333333333334,0.11538461538461539,0.44086021505376344,6,3,-7,1.096774193548387,2.619047619047619,28,110,0.5652985074626866,6.0,-7.0,57.115671641791046,1,68,1,42.0,0.0,42.0,1.096774193548387,1
697,S Stephens,M Minella,697,1,0,65,43,35,18,58,48,42,26,0.4375,0.34615384615384615,0.3763440860215054,7,-5,-8,1.1206896551724137,2.857142857142857,61,100,0.5652985074626866,7.0,-8.0,57.115671641791046,1,65,1,35.0,0.0,35.0,1.1206896551724137,0
698,M Keys,J Jankovic,698,1,1,64,28,36,14,58,19,42,13,0.4583333333333333,0.2692307692307692,0.3763440860215054,6,9,1,1.103448275862069,2.7777777777777777,42,100,0.5652985074626866,6.0,1.0,57.115671641791046,1,64,1,36.0,1.0,36.0,1.103448275862069,1
699,L Dominguez Lino,L Robson,699,1,1,57,27,43,7,60,20,40,8,0.6041666666666666,0.1346153846153846,0.3548387096774194,-3,7,-1,0.95,2.3255813953488373,34,100,0.5652985074626866,-3.0,-1.0,57.115671641791046,1,57,1,43.0,1.0,43.0,0.95,1
700,L Arruabarrena,J Hampton,700,1,1,61,27,39,13,52,16,48,12,0.5208333333333334,0.25,0.44086021505376344,9,11,1,1.1730769230769231,2.5641025641025643,40,100,0.5652985074626866,9.0,1.0,57.115671641791046,1,61,1,39.0,1.0,39.0,1.1730769230769231,1
701,S Lisicki,V Dushevina,701,1,0,54,21,46,14,43,22,57,22,0.6666666666666666,0.2692307692307692,0.5376344086021505,11,-1,-8,1.255813953488372,2.1739130434782608,35,100,0.5652985074626866,11.0,-8.0,57.115671641791046,1,54,1,46.0,0.0,46.0,1.255813953488372,0
702,K Date-Krumm,P Ormaechea,702,1,1,59,32,41,10,69,28,31,6,0.5625,0.19230769230769232,0.25806451612903225,-10,4,4,0.855072463768116,2.4390243902439024,42,100,0.5652985074626866,-10.0,4.0,57.115671641791046,1,59,1,41.0,1.0,41.0,0.855072463768116,1
703,E Bouchard,K Pliskova,703,1,0,53,48,47,21,72,45,28,16,0.6875,0.40384615384615385,0.22580645161290322,-19,3,5,0.7361111111111112,2.127659574468085,69,100,0.5652985074626866,-19.0,5.0,57.115671641791046,1,53,1,47.0,0.0,47.0,0.7361111111111112,1
704,A Kerber,L Hradecka,704,1,0,49,17,51,4,50,16,50,14,0.7708333333333334,0.07692307692307693,0.46236559139784944,-1,1,-10,0.98,1.9607843137254901,21,100,0.5652985074626866,-1.0,-10.0,57.115671641791046,1,49,1,51.0,0.0,51.0,0.98,1
705,C Suarez Navarro,L Davis,705,1,0,63,12,37,3,78,21,22,4,0.4791666666666667,0.057692307692307696,0.16129032258064516,-15,-9,-1,0.8076923076923077,2.7027027027027026,15,100,0.5652985074626866,-15.0,-1.0,57.115671641791046,1,63,1,37.0,0.0,37.0,0.8076923076923077,0
706,A Medina Garrigues,K Mladenovic,706,1,1,51,29,49,15,61,32,39,11,0.7291666666666666,0.28846153846153844,0.34408602150537637,-10,-3,4,0.8360655737704918,2.0408163265306123,44,100,0.5652985074626866,-10.0,4.0,57.115671641791046,1,51,1,49.0,1.0,49.0,0.8360655737704918,0
707,A.Murray,B.Becker,707,1,0,59,29,41,14,57,39,43,20,0.5625,0.2692307692307692,0.3870967741935484,2,-10,-6,1.0350877192982457,2.4390243902439024,43,100,0.5652985074626866,2.0,-6.0,57.115671641791046,1,59,1,41.0,0.0,41.0,1.0350877192982457,0
708,Y-H.Lu,J.Ward,708,1,0,62,77,38,35,67,85,33,31,0.5,0.6730769230769231,0.27956989247311825,-5,-8,4,0.9253731343283582,2.6315789473684212,112,100,0.5652985074626866,-5.0,4.0,57.115671641791046,1,62,1,38.0,0.0,38.0,0.9253731343283582,0
709,J.Hajek,N.Mahut,709,1,1,72,44,28,10,70,34,30,14,0.2916666666666667,0.19230769230769232,0.24731182795698925,2,10,-4,1.0285714285714285,3.5714285714285716,54,100,0.5652985074626866,2.0,-4.0,57.115671641791046,1,72,1,28.0,1.0,28.0,1.0285714285714285,1
710,A.Bogomolov Jr.,T.Robredo,710,1,1,77,40,23,12,79,35,21,8,0.1875,0.23076923076923078,0.15053763440860216,-2,5,4,0.9746835443037974,4.3478260869565215,52,100,0.5652985074626866,-2.0,4.0,57.115671641791046,1,77,1,23.0,1.0,23.0,0.9746835443037974,1
711,M.Youzhny,R.Haase,711,1,0,68,61,32,15,67,53,33,17,0.375,0.28846153846153844,0.27956989247311825,1,8,-2,1.0149253731343284,3.125,76,100,0.5652985074626866,1.0,-2.0,57.115671641791046,1,68,1,32.0,0.0,32.0,1.0149253731343284,1
712,V.Pospisil,M.Gicquel,712,1,0,59,41,41,27,70,56,30,11,0.5625,0.5192307692307693,0.24731182795698925,-11,-15,16,0.8428571428571429,2.4390243902439024,68,100,0.5652985074626866,-11.0,16.0,57.115671641791046,1,59,1,41.0,0.0,41.0,0.8428571428571429,0
713,A.Montanes,A.Kuznetsov,713,1,1,63,56,37,21,73,59,27,14,0.4791666666666667,0.40384615384615385,0.21505376344086022,-10,-3,7,0.863013698630137,2.7027027027027026,77,100,0.5652985074626866,-10.0,7.0,57.115671641791046,1,63,1,38.0,1.0,37.0,0.863013698630137,0
714,V.Troicki,J.Tipsarevic,714,1,0,61,47,39,21,71,55,29,16,0.5208333333333334,0.40384615384615385,0.23655913978494625,-10,-8,5,0.8591549295774648,2.5641025641025643,68,100,0.5652985074626866,-10.0,5.0,57.115671641791046,1,61,1,39.0,0.0,39.0,0.8591549295774648,0
715,M.Cilic,M.Baghdatis,715,1,0,61,31,39,16,70,45,30,16,0.5208333333333334,0.3076923076923077,0.24731182795698925,-9,-14,0,0.8714285714285714,2.5641025641025643,47,100,0.5652985074626866,-9.0,0.0,57.115671641791046,1,61,1,39.0,0.0,39.0,0.8714285714285714,0
716,P.Lorenzi,K.De Schepper,716,1,1,67,56,33,21,54,40,46,22,0.3958333333333333,0.40384615384615385,0.41935483870967744,13,16,-1,1.2407407407407407,3.0303030303030303,77,100,0.5652985074626866,13.0,-1.0,57.115671641791046,1,67,1,33.0,1.0,33.0,1.2407407407407407,1
717,R.Ram,L.Lacko,717,1,0,64,66,36,18,67,64,33,23,0.4583333333333333,0.34615384615384615,0.27956989247311825,-3,2,-5,0.9552238805970149,2.7777777777777777,84,100,0.5652985074626866,-3.0,-5.0,57.115671641791046,1,64,1,36.0,0.0,36.0,0.9552238805970149,1
718,B.Knittel,J.Monaco,718,1,1,78,46,22,9,58,33,42,17,0.16666666666666666,0.17307692307692307,0.3763440860215054,20,13,-8,1.3448275862068966,4.545454545454546,55,100,0.5652985074626866,20.0,-8.0,57.115671641791046,1,78,1,22.0,1.0,22.0,1.3448275862068966,1
719,J.Benneteau,T.Kamke,719,1,0,69,60,31,14,63,65,37,26,0.3541666666666667,0.2692307692307692,0.3225806451612903,6,-5,-12,1.0952380952380953,3.225806451612903,74,100,0.5652985074626866,6.0,-12.0,57.115671641791046,1,69,1,31.0,0.0,31.0,1.0952380952380953,0
720,X.Malisse,F.Verdasco,720,1,1,63,58,37,21,63,48,37,24,0.4791666666666667,0.40384615384615385,0.3225806451612903,0,10,-3,1.0,2.7027027027027026,79,100,0.5652985074626866,0.0,-3.0,57.115671641791046,1,63,1,37.0,1.0,37.0,1.0,1
721,E.Gulbis,E.Roger-Vasselin,721,1,0,66,48,34,21,65,59,35,20,0.4166666666666667,0.40384615384615385,0.3010752688172043,1,-11,1,1.0153846153846153,2.9411764705882355,69,100,0.5652985074626866,1.0,1.0,57.115671641791046,1,66,1,34.0,0.0,34.0,1.0153846153846153,0
722,D.Goffin,J-W.Tsonga,722,1,1,68,54,32,15,71,46,29,19,0.375,0.28846153846153844,0.23655913978494625,-3,8,-4,0.9577464788732394,3.125,69,100,0.5652985074626866,-3.0,-4.0,57.115671641791046,1,68,1,32.0,1.0,32.0,0.9577464788732394,1
723,R.Federer,V.Hanescu,723,1,0,85,26,15,3,70,35,30,14,0.020833333333333332,0.057692307692307696,0.24731182795698925,15,-9,-11,1.2142857142857142,6.666666666666667,29,100,0.5652985074626866,15.0,-11.0,57.115671641791046,1,85,1,15.0,0.0,15.0,1.2142857142857142,0
724,S.Stakhovsky,R.Dutra Silva,724,1,0,54,27,46,17,62,38,38,20,0.6666666666666666,0.3269230769230769,0.3333333333333333,-8,-11,-3,0.8709677419354839,2.1739130434782608,44,100,0.5652985074626866,-8.0,-3.0,57.115671641791046,1,54,1,46.0,0.0,46.0,0.8709677419354839,0
725,L.Rosol,J.Reister,725,1,1,68,102,32,27,59,81,41,39,0.375,0.5192307692307693,0.3655913978494624,9,21,-12,1.152542372881356,3.125,129,100,0.5652985074626866,9.0,-12.0,57.115671641791046,1,68,1,32.0,1.0,32.0,1.152542372881356,1
726,J.Melzer,F.Fognini,726,1,0,66,52,34,21,69,62,31,22,0.4166666666666667,0.40384615384615385,0.25806451612903225,-3,-10,-1,0.9565217391304348,2.9411764705882355,73,100,0.5652985074626866,-3.0,-1.0,57.115671641791046,1,66,1,34.0,0.0,34.0,0.9565217391304348,0
727,J.Janowicz,K.Edmund,727,1,0,71,39,29,10,68,40,32,17,0.3125,0.19230769230769232,0.26881720430107525,3,-1,-7,1.0441176470588236,3.4482758620689653,49,100,0.5652985074626866,3.0,-7.0,57.115671641791046,1,71,1,29.0,0.0,29.0,1.0441176470588236,0
728,M.Reid,R.Stepanek,728,1,1,66,37,34,17,60,34,40,12,0.4166666666666667,0.3269230769230769,0.3548387096774194,6,3,5,1.1,2.9411764705882355,54,100,0.5652985074626866,6.0,5.0,57.115671641791046,1,66,1,34.0,1.0,34.0,1.1,1
729,G.Rufin,M.Matosevic,729,1,0,53,43,47,22,47,42,53,26,0.6875,0.4230769230769231,0.4946236559139785,6,1,-4,1.127659574468085,2.127659574468085,65,100,0.5652985074626866,6.0,-4.0,57.115671641791046,1,53,1,47.0,0.0,47.0,1.127659574468085,1
730,J.Zopp,N.Almagro,730,1,1,55,43,45,29,52,51,48,27,0.6458333333333334,0.5576923076923077,0.44086021505376344,3,-8,2,1.0576923076923077,2.2222222222222223,72,100,0.5652985074626866,3.0,2.0,57.115671641791046,1,55,1,45.0,1.0,45.0,1.0576923076923077,0
731,S.Wawrinka,L.Hewitt,731,1,1,57,37,43,26,60,41,40,20,0.6041666666666666,0.5,0.3548387096774194,-3,-4,6,0.95,2.3255813953488373,63,100,0.5652985074626866,-3.0,6.0,57.115671641791046,1,57,1,43.0,1.0,43.0,0.95,0
732,G.Garcia-Lopez,D.Brown,732,1,1,75,47,25,12,67,32,33,10,0.22916666666666666,0.23076923076923078,0.27956989247311825,8,15,2,1.1194029850746268,4.0,59,100,0.5652985074626866,8.0,2.0,57.115671641791046,1,75,1,25.0,1.0,25.0,1.1194029850746268,1
733,A.Mannarino,P.Andujar,733,1,0,60,32,40,12,63,31,37,17,0.5416666666666666,0.23076923076923078,0.3225806451612903,-3,1,-5,0.9523809523809523,2.5,44,100,0.5652985074626866,-3.0,-5.0,57.115671641791046,1,60,1,40.0,0.0,40.0,0.9523809523809523,1
734,E.Donskoy,J.Isner,734,1,1,75,55,25,19,65,47,35,15,0.22916666666666666,0.36538461538461536,0.3010752688172043,10,8,4,1.1538461538461537,4.0,74,100,0.5652985074626866,10.0,4.0,57.115671641791046,1,75,1,25.0,1.0,25.0,1.1538461538461537,1
735,B.Paire,A.Ungur,735,1,0,59,43,41,25,63,51,37,18,0.5625,0.4807692307692308,0.3225806451612903,-4,-8,7,0.9365079365079365,2.4390243902439024,68,100,0.5652985074626866,-4.0,7.0,57.115671641791046,1,59,1,41.0,0.0,41.0,0.9365079365079365,0
736,A.Falla,S.Robert,736,1,1,68,50,32,13,57,41,43,22,0.375,0.25,0.3870967741935484,11,9,-9,1.1929824561403508,3.125,63,100,0.5652985074626866,11.0,-9.0,57.115671641791046,1,68,1,32.0,1.0,32.0,1.1929824561403508,1
737,I.Andreev,L.Kubot,737,1,1,60,34,40,16,69,28,31,9,0.5416666666666666,0.3076923076923077,0.25806451612903225,-9,6,7,0.8695652173913043,2.5,50,100,0.5652985074626866,-9.0,7.0,57.115671641791046,1,60,1,40.0,1.0,40.0,0.8695652173913043,1
738,S.Darcis,R.Nadal,738,1,0,67,52,33,21,60,53,40,28,0.3958333333333333,0.40384615384615385,0.3548387096774194,7,-1,-7,1.1166666666666667,3.0303030303030303,73,100,0.5652985074626866,7.0,-7.0,57.115671641791046,1,67,1,33.0,0.0,33.0,1.1166666666666667,0
739,J.Del Potro,A.Ramos,739,1,0,58,30,42,8,73,45,27,12,0.5833333333333334,0.15384615384615385,0.21505376344086022,-15,-15,-4,0.7945205479452054,2.380952380952381,38,100,0.5652985074626866,-15.0,-4.0,57.115671641791046,1,58,1,42.0,0.0,42.0,0.7945205479452054,0
740,J.Levine,G.Pella,740,1,0,65,58,35,26,63,63,37,29,0.4375,0.5,0.3225806451612903,2,-5,-3,1.0317460317460319,2.857142857142857,84,100,0.5652985074626866,2.0,-3.0,57.115671641791046,1,65,1,35.0,0.0,35.0,1.0317460317460319,0
741,M.Russell,G.Zemlja,741,1,1,68,67,32,20,66,60,34,17,0.375,0.38461538461538464,0.2903225806451613,2,7,3,1.0303030303030303,3.125,87,100,0.5652985074626866,2.0,3.0,57.115671641791046,1,68,1,32.0,1.0,32.0,1.0303030303030303,1
742,S.Bolelli,G.Dimitrov,742,1,1,73,43,27,10,59,34,41,13,0.2708333333333333,0.19230769230769232,0.3655913978494624,14,9,-3,1.2372881355932204,3.7037037037037037,53,100,0.5652985074626866,14.0,-3.0,57.115671641791046,1,73,1,27.0,1.0,27.0,1.2372881355932204,1
743,A.Seppi,D.Istomin,743,1,0,62,78,38,32,61,84,39,36,0.5,0.6153846153846154,0.34408602150537637,1,-6,-4,1.0163934426229508,2.6315789473684212,110,100,0.5652985074626866,1.0,-4.0,57.115671641791046,1,62,1,38.0,0.0,38.0,1.0163934426229508,0
744,J.Nieminen,M.Llodra,744,1,1,62,43,38,21,65,44,35,18,0.5,0.40384615384615385,0.3010752688172043,-3,-1,3,0.9538461538461539,2.6315789473684212,64,100,0.5652985074626866,-3.0,3.0,57.115671641791046,1,62,1,38.0,1.0,38.0,0.9538461538461539,0
745,A.Bedene,L.Mayer,745,1,1,63,47,37,20,60,34,40,16,0.4791666666666667,0.38461538461538464,0.3548387096774194,3,13,4,1.05,2.7027027027027026,67,100,0.5652985074626866,3.0,4.0,57.115671641791046,1,63,1,37.0,1.0,37.0,1.05,1
746,M.Ebden,K.Nishikori,746,1,1,67,37,33,19,61,39,39,12,0.3958333333333333,0.36538461538461536,0.34408602150537637,6,-2,7,1.098360655737705,3.0303030303030303,56,100,0.5652985074626866,6.0,7.0,57.115671641791046,1,67,1,33.0,1.0,33.0,1.098360655737705,0
747,P.Kohlschreiber,I.Dodig,747,1,1,65,84,35,25,57,75,43,37,0.4375,0.4807692307692308,0.3870967741935484,8,9,-12,1.1403508771929824,2.857142857142857,109,100,0.5652985074626866,8.0,-12.0,57.115671641791046,1,65,1,35.0,1.0,35.0,1.1403508771929824,1
748,D.Kudla,J.Duckworth,748,1,0,58,63,42,20,61,63,39,35,0.5833333333333334,0.38461538461538464,0.34408602150537637,-3,0,-15,0.9508196721311475,2.380952380952381,83,100,0.5652985074626866,-3.0,-15.0,57.115671641791046,1,58,1,42.0,0.0,42.0,0.9508196721311475,0
749,I.Sijsling,A.Kuznetsov,749,1,0,61,39,39,11,60,49,40,21,0.5208333333333334,0.21153846153846154,0.3548387096774194,1,-10,-10,1.0166666666666666,2.5641025641025643,50,100,0.5652985074626866,1.0,-10.0,57.115671641791046,1,61,1,38.0,0.0,39.0,1.0166666666666666,0
750,C.Berlocq,M.Raonic,750,1,1,71,45,29,13,64,42,36,18,0.3125,0.25,0.3118279569892473,7,3,-5,1.109375,3.4482758620689653,58,100,0.5652985074626866,7.0,-5.0,57.115671641791046,1,71,1,29.0,1.0,29.0,1.109375,1
751,A.Dolgopolov,G.Elias,751,1,0,43,22,57,26,64,38,36,19,0.8958333333333334,0.5,0.3118279569892473,-21,-16,7,0.671875,1.7543859649122806,48,100,0.5652985074626866,-21.0,7.0,57.115671641791046,1,43,1,57.0,0.0,57.0,0.671875,0
752,S.Giraldo,H.Zeballos,752,1,0,61,66,39,37,73,76,27,30,0.5208333333333334,0.7115384615384616,0.21505376344086022,-12,-10,7,0.8356164383561644,2.5641025641025643,103,100,0.5652985074626866,-12.0,7.0,57.115671641791046,1,61,1,39.0,0.0,39.0,0.8356164383561644,0
753,T.Gabashvili,R.Bautista Agut,753,1,1,75,63,25,16,58,40,42,21,0.22916666666666666,0.3076923076923077,0.3763440860215054,17,23,-5,1.293103448275862,4.0,79,100,0.5652985074626866,17.0,-5.0,57.115671641791046,1,75,1,25.0,1.0,25.0,1.293103448275862,1
754,M.Alund,D.Ferrer,754,1,1,68,57,32,15,74,53,26,13,0.375,0.28846153846153844,0.20430107526881722,-6,4,2,0.918918918918919,3.125,72,100,0.5652985074626866,-6.0,2.0,57.115671641791046,1,68,1,32.0,1.0,32.0,0.918918918918919,1
755,T.Berdych,M.Klizan,755,1,0,64,38,36,18,62,47,38,17,0.4583333333333333,0.34615384615384615,0.3333333333333333,2,-9,1,1.032258064516129,2.7777777777777777,56,100,0.5652985074626866,2.0,1.0,57.115671641791046,1,64,1,36.0,0.0,36.0,1.032258064516129,0
756,D.Gimeno-Traver,D.Brands,756,1,1,65,90,35,38,69,93,31,27,0.4375,0.7307692307692307,0.25806451612903225,-4,-3,11,0.9420289855072463,2.857142857142857,128,100,0.5652985074626866,-4.0,11.0,57.115671641791046,1,65,1,35.0,1.0,35.0,0.9420289855072463,0
757,M.Przysiezny,P.Petzschner,757,1,0,65,31,35,11,56,41,44,21,0.4375,0.21153846153846154,0.3978494623655914,9,-10,-10,1.1607142857142858,2.857142857142857,42,100,0.5652985074626866,9.0,-10.0,57.115671641791046,1,65,1,35.0,0.0,35.0,1.1607142857142858,0
758,O.Rochus,K.Anderson,758,1,1,72,39,28,14,62,30,38,17,0.2916666666666667,0.2692307692307692,0.3333333333333333,10,9,-3,1.1612903225806452,3.5714285714285716,53,100,0.5652985074626866,10.0,-3.0,57.115671641791046,1,72,1,28.0,1.0,28.0,1.1612903225806452,1
759,S.Querrey,B.Tomic,759,1,1,78,86,22,20,64,81,36,28,0.16666666666666666,0.38461538461538464,0.3118279569892473,14,5,-8,1.21875,4.545454545454546,106,100,0.5652985074626866,14.0,-8.0,57.115671641791046,1,78,1,22.0,1.0,22.0,1.21875,1
760,T.De Bakker,J.Blake,760,1,1,52,30,48,20,64,30,36,14,0.7083333333333334,0.38461538461538464,0.3118279569892473,-12,0,6,0.8125,2.0833333333333335,50,100,0.5652985074626866,-12.0,6.0,57.115671641791046,1,52,1,48.0,1.0,48.0,0.8125,0
761,G.Soeda,A.Haider-Maurer,761,1,0,56,43,44,18,55,39,45,25,0.625,0.34615384615384615,0.40860215053763443,1,4,-7,1.018181818181818,2.272727272727273,61,100,0.5652985074626866,1.0,-7.0,57.115671641791046,1,56,1,44.0,0.0,44.0,1.018181818181818,1
762,M.Granollers,R.Gasquet,762,1,1,65,65,35,22,72,73,28,15,0.4375,0.4230769230769231,0.22580645161290322,-7,-8,7,0.9027777777777778,2.857142857142857,87,100,0.5652985074626866,-7.0,7.0,57.115671641791046,1,65,1,35.0,1.0,35.0,0.9027777777777778,0
763,T.Haas,D.Tursunov,763,1,0,56,37,44,24,64,56,36,18,0.625,0.46153846153846156,0.3118279569892473,-8,-19,6,0.875,2.272727272727273,61,100,0.5652985074626866,-8.0,6.0,57.115671641791046,1,56,1,44.0,0.0,44.0,0.875,0
764,Y-T.Wang,W.Odesnik,764,1,0,70,73,30,28,69,69,31,22,0.3333333333333333,0.5384615384615384,0.25806451612903225,1,4,6,1.0144927536231885,3.3333333333333335,101,100,0.5652985074626866,1.0,6.0,57.115671641791046,1,70,1,30.0,0.0,30.0,1.0144927536231885,1
765,P-H.Mathieu,R.Berankis,765,1,0,52,73,48,36,61,73,39,30,0.7083333333333334,0.6923076923076923,0.34408602150537637,-9,0,6,0.8524590163934426,2.0833333333333335,109,100,0.5652985074626866,-9.0,6.0,57.115671641791046,1,52,1,48.0,0.0,48.0,0.8524590163934426,0
766,F.Lopez,G.Simon,766,1,0,60,49,40,27,71,55,29,17,0.5416666666666666,0.5192307692307693,0.23655913978494625,-11,-6,10,0.8450704225352113,2.5,76,100,0.5652985074626866,-11.0,10.0,57.115671641791046,1,60,1,40.0,0.0,40.0,0.8450704225352113,0
767,J.Chardy,R.Harrison,767,1,0,65,70,35,30,66,66,34,22,0.4375,0.5769230769230769,0.2903225806451613,-1,4,8,0.9848484848484849,2.857142857142857,100,100,0.5652985074626866,-1.0,8.0,57.115671641791046,1,65,1,35.0,0.0,35.0,0.9848484848484849,1
768,J.Struff,B.Kavcic,768,1,0,58,40,42,12,59,38,41,22,0.5833333333333334,0.23076923076923078,0.3655913978494624,-1,2,-10,0.9830508474576272,2.380952380952381,52,100,0.5652985074626866,-1.0,-10.0,57.115671641791046,1,58,1,42.0,0.0,42.0,0.9830508474576272,1
769,S.Johnson,B.Reynolds,769,1,1,62,68,38,38,55,76,45,39,0.5,0.7307692307692307,0.40860215053763443,7,-8,-1,1.1272727272727272,2.6315789473684212,106,100,0.5652985074626866,7.0,-1.0,57.115671641791046,1,62,1,38.0,1.0,38.0,1.1272727272727272,0
770,F.Mayer,N.Djokovic,770,1,1,63,41,37,26,60,46,40,20,0.4791666666666667,0.5,0.3548387096774194,3,-5,6,1.05,2.7027027027027026,67,100,0.5652985074626866,3.0,6.0,57.115671641791046,1,63,1,37.0,1.0,37.0,1.05,0
771,A.Murray,Y-H.Lu,771,2,0,66,49,34,13,63,44,37,20,0.4166666666666667,0.25,0.3225806451612903,3,5,-7,1.0476190476190477,2.9411764705882355,62,100,-0.4467005076142132,3.0,-7.0,54.19796954314721,2,66,1,34.0,0.0,34.0,1.0476190476190477,1
772,N.Mahut,T.Robredo,772,2,1,63,52,37,28,65,48,35,18,0.4791666666666667,0.5384615384615384,0.3010752688172043,-2,4,10,0.9692307692307692,2.7027027027027026,80,100,-0.4467005076142132,-2.0,10.0,54.19796954314721,2,63,1,37.0,1.0,37.0,0.9692307692307692,1
773,M.Youzhny,V.Pospisil,773,2,0,63,83,37,25,64,76,36,39,0.4791666666666667,0.4807692307692308,0.3118279569892473,-1,7,-14,0.984375,2.7027027027027026,108,100,-0.4467005076142132,-1.0,-14.0,54.19796954314721,2,63,1,37.0,0.0,37.0,0.984375,1
774,A.Kuznetsov,V.Troicki,774,2,1,63,43,37,16,65,34,35,15,0.4791666666666667,0.3076923076923077,0.3010752688172043,-2,9,1,0.9692307692307692,2.7027027027027026,59,100,-0.4467005076142132,-2.0,1.0,54.19796954314721,2,63,1,37.0,1.0,37.0,0.9692307692307692,1
775,R.Ram,J.Monaco,775,2,1,68,54,32,24,77,68,23,11,0.375,0.46153846153846156,0.17204301075268819,-9,-14,13,0.8831168831168831,3.125,78,100,-0.4467005076142132,-9.0,13.0,54.19796954314721,2,68,1,32.0,1.0,32.0,0.8831168831168831,0
776,J.Benneteau,F.Verdasco,776,2,1,55,48,45,27,62,55,38,24,0.6458333333333334,0.5192307692307693,0.3333333333333333,-7,-7,3,0.8870967741935484,2.2222222222222223,75,100,-0.4467005076142132,-7.0,3.0,54.19796954314721,2,55,1,45.0,1.0,45.0,0.8870967741935484,0
777,E.Gulbis,J-W.Tsonga,777,2,0,68,40,32,13,61,40,39,17,0.375,0.25,0.34408602150537637,7,0,-4,1.1147540983606556,3.125,53,100,-0.4467005076142132,7.0,-4.0,54.19796954314721,2,68,1,32.0,0.0,32.0,1.1147540983606556,0
778,R.Federer,S.Stakhovsky,778,2,1,66,83,34,36,72,91,28,24,0.4166666666666667,0.6923076923076923,0.22580645161290322,-6,-8,12,0.9166666666666666,2.9411764705882355,119,100,-0.4467005076142132,-6.0,12.0,54.19796954314721,2,66,1,34.0,1.0,34.0,0.9166666666666666,0
779,J.Reister,J.Melzer,779,2,1,64,60,36,33,70,68,30,27,0.4583333333333333,0.6346153846153846,0.24731182795698925,-6,-8,6,0.9142857142857143,2.7777777777777777,93,100,-0.4467005076142132,-6.0,6.0,54.19796954314721,2,64,1,36.0,1.0,36.0,0.9142857142857143,0
780,G.Rufin,N.Almagro,780,2,1,69,71,31,20,63,63,37,18,0.3541666666666667,0.38461538461538464,0.3225806451612903,6,8,2,1.0952380952380953,3.225806451612903,91,100,-0.4467005076142132,6.0,2.0,54.19796954314721,2,69,1,31.0,1.0,31.0,1.0952380952380953,1
781,L.Hewitt,D.Brown,781,2,1,64,71,36,25,55,52,45,29,0.4583333333333333,0.4807692307692308,0.40860215053763443,9,19,-4,1.1636363636363636,2.7777777777777777,96,100,-0.4467005076142132,9.0,-4.0,54.19796954314721,2,64,1,36.0,1.0,36.0,1.1636363636363636,1
782,B.Paire,S.Robert,782,2,0,61,42,39,23,57,49,43,23,0.5208333333333334,0.4423076923076923,0.3870967741935484,4,-7,0,1.0701754385964912,2.5641025641025643,65,100,-0.4467005076142132,4.0,0.0,54.19796954314721,2,61,1,39.0,0.0,39.0,1.0701754385964912,0
783,J.Del Potro,J.Levine,783,2,0,61,41,39,16,69,46,31,16,0.5208333333333334,0.3076923076923077,0.25806451612903225,-8,-5,0,0.8840579710144928,2.5641025641025643,57,100,-0.4467005076142132,-8.0,0.0,54.19796954314721,2,61,1,39.0,0.0,39.0,0.8840579710144928,0
784,G.Zemlja,G.Dimitrov,784,2,0,68,92,32,33,56,79,44,47,0.375,0.6346153846153846,0.3978494623655914,12,13,-14,1.2142857142857142,3.125,125,100,-0.4467005076142132,12.0,-14.0,54.19796954314721,2,68,1,32.0,0.0,32.0,1.2142857142857142,1
785,L.Mayer,K.Nishikori,785,2,1,67,51,33,19,65,44,35,15,0.3958333333333333,0.36538461538461536,0.3010752688172043,2,7,4,1.0307692307692307,3.0303030303030303,70,100,-0.4467005076142132,2.0,4.0,54.19796954314721,2,67,1,33.0,1.0,33.0,1.0307692307692307,1
786,I.Dodig,D.Kudla,786,2,0,57,39,43,24,61,55,39,22,0.6041666666666666,0.46153846153846156,0.34408602150537637,-4,-16,2,0.9344262295081968,2.3255813953488373,63,100,-0.4467005076142132,-4.0,2.0,54.19796954314721,2,57,1,43.0,0.0,43.0,0.9344262295081968,0
787,I.Sijsling,M.Raonic,787,2,0,68,57,32,17,67,52,33,23,0.375,0.3269230769230769,0.27956989247311825,1,5,-6,1.0149253731343284,3.125,74,100,-0.4467005076142132,1.0,-6.0,54.19796954314721,2,68,1,32.0,0.0,32.0,1.0149253731343284,1
788,T.Berdych,D.Brands,788,2,0,75,53,25,11,58,40,42,26,0.22916666666666666,0.21153846153846154,0.3763440860215054,17,13,-15,1.293103448275862,4.0,64,100,-0.4467005076142132,17.0,-15.0,54.19796954314721,2,75,1,25.0,0.0,25.0,1.293103448275862,1
789,M.Przysiezny,K.Anderson,789,2,1,69,49,31,18,60,42,40,21,0.3541666666666667,0.34615384615384615,0.3548387096774194,9,7,-3,1.15,3.225806451612903,67,100,-0.4467005076142132,9.0,-3.0,54.19796954314721,2,69,1,31.0,1.0,31.0,1.15,1
790,B.Tomic,J.Blake,790,2,0,59,37,41,16,72,54,28,13,0.5625,0.3076923076923077,0.22580645161290322,-13,-17,3,0.8194444444444444,2.4390243902439024,53,100,-0.4467005076142132,-13.0,3.0,54.19796954314721,2,59,1,41.0,0.0,41.0,0.8194444444444444,0
791,G.Soeda,R.Gasquet,791,2,1,57,47,43,23,56,45,44,20,0.6041666666666666,0.4423076923076923,0.3978494623655914,1,2,3,1.0178571428571428,2.3255813953488373,70,100,-0.4467005076142132,1.0,3.0,54.19796954314721,2,57,1,43.0,1.0,43.0,1.0178571428571428,1
792,J.Chardy,J.Struff,792,2,1,55,36,45,17,59,28,41,16,0.6458333333333334,0.3269230769230769,0.3655913978494624,-4,8,1,0.9322033898305084,2.2222222222222223,53,100,-0.4467005076142132,-4.0,1.0,54.19796954314721,2,55,1,45.0,1.0,45.0,0.9322033898305084,1
793,B.Reynolds,N.Djokovic,793,2,1,59,39,41,22,68,53,32,15,0.5625,0.4230769230769231,0.26881720430107525,-9,-14,7,0.8676470588235294,2.4390243902439024,61,100,-0.4467005076142132,-9.0,7.0,54.19796954314721,2,59,1,41.0,1.0,41.0,0.8676470588235294,0
794,A.Murray,T.Robredo,794,3,0,67,47,33,12,65,44,35,16,0.3958333333333333,0.23076923076923078,0.3010752688172043,2,3,-4,1.0307692307692307,3.0303030303030303,59,100,0.037383177570093455,2.0,-4.0,50.467289719626166,3,67,1,33.0,0.0,33.0,1.0307692307692307,1
795,S.Stakhovsky,J.Melzer,795,3,1,67,51,33,19,62,45,38,21,0.3958333333333333,0.36538461538461536,0.3333333333333333,5,6,-2,1.0806451612903225,3.0303030303030303,70,100,0.037383177570093455,5.0,-2.0,50.467289719626166,3,67,1,33.0,1.0,33.0,1.0806451612903225,1
796,J.Janowicz,N.Almagro,796,3,0,72,58,28,8,69,52,31,16,0.2916666666666667,0.15384615384615385,0.25806451612903225,3,6,-8,1.0434782608695652,3.5714285714285716,66,100,0.037383177570093455,3.0,-8.0,50.467289719626166,3,72,1,28.0,0.0,28.0,1.0434782608695652,1
797,D.Brown,A.Mannarino,797,3,1,65,44,35,20,58,42,42,16,0.4375,0.38461538461538464,0.3763440860215054,7,2,4,1.1206896551724137,2.857142857142857,64,100,0.037383177570093455,7.0,4.0,50.467289719626166,3,65,1,35.0,1.0,35.0,1.1206896551724137,1
798,J.Del Potro,G.Zemlja,798,3,0,67,53,33,11,61,47,39,20,0.3958333333333333,0.21153846153846154,0.34408602150537637,6,6,-9,1.098360655737705,3.0303030303030303,64,100,0.037383177570093455,6.0,-9.0,50.467289719626166,3,67,1,33.0,0.0,33.0,1.098360655737705,1
799,A.Seppi,K.Nishikori,799,3,0,69,63,31,23,60,65,40,34,0.3541666666666667,0.4423076923076923,0.3548387096774194,9,-2,-11,1.15,3.225806451612903,86,100,0.037383177570093455,9.0,-11.0,50.467289719626166,3,69,1,31.0,0.0,31.0,1.15,0
800,I.Dodig,I.Sijsling,800,3,0,62,12,38,4,47,12,53,17,0.5,0.07692307692307693,0.4946236559139785,15,0,-13,1.3191489361702127,2.6315789473684212,16,100,0.037383177570093455,15.0,-13.0,50.467289719626166,3,62,1,38.0,0.0,38.0,1.3191489361702127,0
801,A.Dolgopolov,D.Ferrer,801,3,1,70,76,30,22,59,76,41,33,0.3333333333333333,0.4230769230769231,0.3655913978494624,11,0,-11,1.1864406779661016,3.3333333333333335,98,100,0.037383177570093455,11.0,-11.0,50.467289719626166,3,70,1,30.0,1.0,30.0,1.1864406779661016,0
802,T.Berdych,K.Anderson,802,3,0,60,53,40,25,53,54,47,27,0.5416666666666666,0.4807692307692308,0.43010752688172044,7,-1,-2,1.1320754716981132,2.5,78,100,0.037383177570093455,7.0,-2.0,50.467289719626166,3,60,1,40.0,0.0,40.0,1.1320754716981132,0
803,B.Tomic,R.Gasquet,803,3,0,69,83,31,27,81,101,19,15,0.3541666666666667,0.5192307692307693,0.12903225806451613,-12,-18,12,0.8518518518518519,3.225806451612903,110,100,0.037383177570093455,-12.0,12.0,50.467289719626166,3,69,1,31.0,0.0,31.0,0.8518518518518519,0
804,T.Haas,F.Lopez,804,3,0,54,48,46,30,76,63,24,18,0.6666666666666666,0.5769230769230769,0.1827956989247312,-22,-15,12,0.7105263157894737,2.1739130434782608,78,100,0.037383177570093455,-22.0,12.0,50.467289719626166,3,54,1,46.0,0.0,46.0,0.7105263157894737,0
805,J.Chardy,N.Djokovic,805,3,1,74,40,26,12,66,32,34,15,0.25,0.23076923076923078,0.2903225806451613,8,8,-3,1.121212121212121,3.8461538461538463,52,100,0.037383177570093455,8.0,-3.0,50.467289719626166,3,74,1,26.0,1.0,26.0,1.121212121212121,1
806,A.Murray,M.Youzhny,806,4,0,61,36,39,16,63,55,37,16,0.5208333333333334,0.3076923076923077,0.3225806451612903,-2,-19,0,0.9682539682539683,2.5641025641025643,52,100,0.38181818181818183,-2.0,0.0,55.54545454545455,4,61,1,39.0,0.0,39.0,0.9682539682539683,0
807,K.De Schepper,F.Verdasco,807,4,1,64,42,36,18,67,43,33,15,0.4583333333333333,0.34615384615384615,0.27956989247311825,-3,-1,3,0.9552238805970149,2.7777777777777777,60,100,0.38181818181818183,-3.0,3.0,55.54545454545455,4,64,1,36.0,1.0,36.0,0.9552238805970149,0
808,J.Melzer,J.Janowicz,808,4,1,57,68,43,36,71,76,29,28,0.6041666666666666,0.6923076923076923,0.23655913978494625,-14,-8,8,0.8028169014084507,2.3255813953488373,104,100,0.38181818181818183,-14.0,8.0,55.54545454545455,4,57,1,43.0,1.0,43.0,0.8028169014084507,0
809,A.Mannarino,L.Kubot,809,4,1,67,72,33,25,59,69,41,35,0.3958333333333333,0.4807692307692308,0.3655913978494624,8,3,-10,1.1355932203389831,3.0303030303030303,97,100,0.38181818181818183,8.0,-10.0,55.54545454545455,4,67,1,33.0,1.0,33.0,1.1355932203389831,1
810,J.Del Potro,A.Seppi,810,4,0,59,47,41,18,72,55,28,18,0.5625,0.34615384615384615,0.22580645161290322,-13,-8,0,0.8194444444444444,2.4390243902439024,65,100,0.38181818181818183,-13.0,0.0,55.54545454545455,4,59,1,41.0,0.0,41.0,0.8194444444444444,0
811,I.Dodig,D.Ferrer,811,4,1,66,62,34,29,66,64,34,25,0.4166666666666667,0.5576923076923077,0.2903225806451613,0,-2,4,1.0,2.9411764705882355,91,100,0.38181818181818183,0.0,4.0,55.54545454545455,4,66,1,34.0,1.0,34.0,1.0,0
812,T.Berdych,B.Tomic,812,4,0,71,82,29,22,58,68,42,30,0.3125,0.4230769230769231,0.3763440860215054,13,14,-8,1.2241379310344827,3.4482758620689653,104,100,0.38181818181818183,13.0,-8.0,55.54545454545455,4,71,1,29.0,0.0,29.0,1.2241379310344827,1
813,T.Haas,N.Djokovic,813,4,1,65,44,35,17,73,43,27,14,0.4375,0.3269230769230769,0.21505376344086022,-8,1,3,0.8904109589041096,2.857142857142857,61,100,0.38181818181818183,-8.0,3.0,55.54545454545455,4,65,1,35.0,1.0,35.0,0.8904109589041096,1
814,A.Murray,F.Verdasco,814,5,0,59,63,41,29,69,72,31,23,0.5625,0.5576923076923077,0.25806451612903225,-10,-9,6,0.855072463768116,2.4390243902439024,92,100,-1.2222222222222223,-10.0,6.0,54.333333333333336,5,59,1,41.0,0.0,41.0,0.855072463768116,0
815,J.Janowicz,L.Kubot,815,5,0,57,44,43,20,68,63,32,12,0.6041666666666666,0.38461538461538464,0.26881720430107525,-11,-19,8,0.8382352941176471,2.3255813953488373,64,100,-1.2222222222222223,-11.0,8.0,54.333333333333336,5,57,1,43.0,0.0,43.0,0.8382352941176471,0
816,J.Del Potro,D.Ferrer,816,5,0,68,45,32,17,72,55,28,11,0.375,0.3269230769230769,0.22580645161290322,-4,-10,6,0.9444444444444444,3.125,62,100,-1.2222222222222223,-4.0,6.0,54.333333333333336,5,68,1,32.0,0.0,32.0,0.9444444444444444,0
817,T.Berdych,N.Djokovic,817,5,1,61,42,39,21,53,33,47,27,0.5208333333333334,0.40384615384615385,0.43010752688172044,8,9,-6,1.150943396226415,2.5641025641025643,63,100,-1.2222222222222223,8.0,-6.0,54.333333333333336,5,61,1,39.0,1.0,39.0,1.150943396226415,1
818,A.Murray,J.Janowicz,818,6,0,55,54,45,27,70,60,30,24,0.6458333333333334,0.5192307692307693,0.24731182795698925,-15,-6,3,0.7857142857142857,2.2222222222222223,81,100,-3.2857142857142856,-15.0,3.0,57.357142857142854,6,55,1,45.0,0.0,45.0,0.7857142857142857,0
819,J.Del Potro,N.Djokovic,819,6,1,69,102,31,21,60,82,40,42,0.3541666666666667,0.40384615384615385,0.3548387096774194,9,20,-21,1.15,3.225806451612903,123,100,-3.2857142857142856,9.0,-21.0,57.357142857142854,6,69,1,31.0,1.0,31.0,1.15,1
820,A.Murray,N.Djokovic,820,7,0,65,40,35,15,64,48,36,16,0.4375,0.28846153846153844,0.3118279569892473,1,-8,-1,1.015625,2.857142857142857,55,100,5.285714285714286,1.0,-1.0,47.857142857142854,7,65,1,35.0,0.0,35.0,1.015625,0
821,V.Azarenka,M.Koehler,821,1,0,60,21,40,8,72,31,28,4,0.5416666666666666,0.15384615384615385,0.22580645161290322,-12,-10,4,0.8333333333333334,2.5,29,100,0.5652985074626866,-12.0,4.0,57.115671641791046,1,60,1,40.0,0.0,40.0,0.8333333333333334,0
822,F.Pennetta,E.Baltacha,822,1,0,69,23,31,6,53,18,47,15,0.3541666666666667,0.11538461538461539,0.43010752688172044,16,5,-9,1.3018867924528301,3.225806451612903,29,100,0.5652985074626866,16.0,-9.0,57.115671641791046,1,69,1,31.0,0.0,31.0,1.3018867924528301,1
823,T.Maria,S-W.Hsieh,823,1,1,63,17,37,10,56,16,44,7,0.4791666666666667,0.19230769230769232,0.3978494623655914,7,1,3,1.125,2.7027027027027026,27,100,0.5652985074626866,7.0,3.0,57.115671641791046,1,63,1,37.0,1.0,37.0,1.125,1
824,V.King,A.Cornet,824,1,1,57,36,43,21,68,45,32,15,0.6041666666666666,0.40384615384615385,0.26881720430107525,-11,-9,6,0.8382352941176471,2.3255813953488373,57,100,0.5652985074626866,-11.0,6.0,57.115671641791046,1,57,1,43.0,1.0,43.0,0.8382352941176471,0
825,K.Flipkens,Y.Putintseva,825,1,0,73,34,27,12,66,33,34,15,0.2708333333333333,0.23076923076923078,0.2903225806451613,7,1,-3,1.106060606060606,3.7037037037037037,46,100,0.5652985074626866,7.0,-3.0,57.115671641791046,1,73,1,27.0,0.0,27.0,1.106060606060606,1
826,B.Jovanovski,A.Tomljanovic,826,1,0,59,38,41,22,69,57,31,18,0.5625,0.4230769230769231,0.25806451612903225,-10,-19,4,0.855072463768116,2.4390243902439024,60,100,0.5652985074626866,-10.0,4.0,57.115671641791046,1,59,1,41.0,0.0,41.0,0.855072463768116,0
827,V.Dolonc,Y.Wickmayer,827,1,0,69,40,31,13,69,33,31,12,0.3541666666666667,0.25,0.25806451612903225,0,7,1,1.0,3.225806451612903,53,100,0.5652985074626866,0.0,1.0,57.115671641791046,1,69,1,31.0,0.0,31.0,1.0,1
828,J.Konta,J.Jankovic,828,1,1,68,31,32,12,52,21,48,17,0.375,0.23076923076923078,0.44086021505376344,16,10,-5,1.3076923076923077,3.125,43,100,0.5652985074626866,16.0,-5.0,57.115671641791046,1,68,1,32.0,1.0,32.0,1.3076923076923077,1
829,A.Ivanovic,V.Razzano,829,1,0,78,21,22,9,67,29,33,10,0.16666666666666666,0.17307692307692307,0.27956989247311825,11,-8,-1,1.164179104477612,4.545454545454546,30,100,0.5652985074626866,11.0,-1.0,57.115671641791046,1,78,1,22.0,0.0,22.0,1.164179104477612,0
830,G.Voskoboeva,E.Bouchard,830,1,1,61,44,39,24,59,49,41,21,0.5208333333333334,0.46153846153846156,0.3655913978494624,2,-5,3,1.0338983050847457,2.5641025641025643,68,100,0.5652985074626866,2.0,3.0,57.115671641791046,1,61,1,39.0,1.0,39.0,1.0338983050847457,0
831,M.Lucic-Baroni,S.Arvidsson,831,1,0,73,19,27,6,64,28,36,14,0.2708333333333333,0.11538461538461539,0.3118279569892473,9,-9,-8,1.140625,3.7037037037037037,25,100,0.5652985074626866,9.0,-8.0,57.115671641791046,1,73,1,27.0,0.0,27.0,1.140625,0
832,L.Dominguez Lino,C.Suarez Navarro,832,1,1,68,27,32,14,64,16,36,5,0.375,0.2692307692307692,0.3118279569892473,4,11,9,1.0625,3.125,41,100,0.5652985074626866,4.0,9.0,57.115671641791046,1,68,1,32.0,1.0,32.0,1.0625,1
833,E.Makarova,J.Larsson,833,1,0,63,20,37,9,82,30,18,7,0.4791666666666667,0.17307692307692307,0.11827956989247312,-19,-10,2,0.7682926829268293,2.7027027027027026,29,100,0.5652985074626866,-19.0,2.0,57.115671641791046,1,63,1,37.0,0.0,37.0,0.7682926829268293,0
834,A.Keothavong,G.Muguruza,834,1,1,67,28,33,9,62,18,38,11,0.3958333333333333,0.17307692307692307,0.3333333333333333,5,10,-2,1.0806451612903225,3.0303030303030303,37,100,0.5652985074626866,5.0,-2.0,57.115671641791046,1,67,1,33.0,1.0,33.0,1.0806451612903225,1
835,Y.Shvedova,K.Bertens,835,1,0,57,31,43,11,59,19,41,11,0.6041666666666666,0.21153846153846154,0.3655913978494624,-2,12,0,0.9661016949152542,2.3255813953488373,42,100,0.5652985074626866,-2.0,0.0,57.115671641791046,1,57,1,43.0,0.0,43.0,0.9661016949152542,1
836,C.Vandeweghe,P.Kvitova,836,1,1,67,40,33,17,64,40,36,20,0.3958333333333333,0.3269230769230769,0.3118279569892473,3,0,-3,1.046875,3.0303030303030303,57,100,0.5652985074626866,3.0,-3.0,57.115671641791046,1,67,1,33.0,1.0,33.0,1.046875,0
837,M.Sharapova,K.Mladenovic,837,1,0,52,29,48,17,68,35,32,14,0.7083333333333334,0.3269230769230769,0.26881720430107525,-16,-6,3,0.7647058823529411,2.0833333333333335,46,100,0.5652985074626866,-16.0,3.0,57.115671641791046,1,52,1,48.0,0.0,48.0,0.7647058823529411,0
838,M.Oudin,M.Larcher De Brito,838,1,1,68,46,32,15,65,32,35,15,0.375,0.28846153846153844,0.3010752688172043,3,14,0,1.0461538461538462,3.125,61,100,0.5652985074626866,3.0,0.0,57.115671641791046,1,68,1,32.0,1.0,32.0,1.0461538461538462,1
839,K.Knapp,L.Hradecka,839,1,0,65,23,35,8,63,34,37,11,0.4375,0.15384615384615385,0.3225806451612903,2,-11,-3,1.0317460317460319,2.857142857142857,31,100,0.5652985074626866,2.0,-3.0,57.115671641791046,1,65,1,35.0,0.0,35.0,1.0317460317460319,0
840,L.Davis,L.Safarova,840,1,1,63,24,37,11,66,21,34,2,0.4791666666666667,0.21153846153846154,0.2903225806451613,-3,3,9,0.9545454545454546,2.7027027027027026,35,100,0.5652985074626866,-3.0,9.0,57.115671641791046,1,63,1,37.0,1.0,37.0,0.9545454545454546,1
841,S.Cirstea,S.Voegele,841,1,0,51,29,49,19,59,32,41,15,0.7291666666666666,0.36538461538461536,0.3655913978494624,-8,-3,4,0.864406779661017,2.0408163265306123,48,100,0.5652985074626866,-8.0,4.0,57.115671641791046,1,51,1,49.0,0.0,49.0,0.864406779661017,0
842,S.Murray,C.Giorgi,842,1,1,54,23,46,19,58,28,42,16,0.6666666666666666,0.36538461538461536,0.3763440860215054,-4,-5,3,0.9310344827586207,2.1739130434782608,42,100,0.5652985074626866,-4.0,3.0,57.115671641791046,1,54,1,46.0,1.0,46.0,0.9310344827586207,0
843,A.Glatch,C.McHale,843,1,1,60,24,40,13,54,26,46,8,0.5416666666666666,0.25,0.41935483870967744,6,-2,5,1.1111111111111112,2.5,37,100,0.5652985074626866,6.0,5.0,57.115671641791046,1,60,1,40.0,1.0,40.0,1.1111111111111112,0
844,E.Svitolina,M.Bartoli,844,1,1,58,29,42,16,56,24,44,14,0.5833333333333334,0.3076923076923077,0.3978494623655914,2,5,2,1.0357142857142858,2.380952380952381,45,100,0.5652985074626866,2.0,2.0,57.115671641791046,1,58,1,42.0,1.0,42.0,1.0357142857142858,1
845,C.Wozniacki,E.Cabeza Candela,845,1,0,68,9,32,3,72,29,28,2,0.375,0.057692307692307696,0.22580645161290322,-4,-20,1,0.9444444444444444,3.125,12,100,0.5652985074626866,-4.0,1.0,57.115671641791046,1,68,1,32.0,0.0,32.0,0.9444444444444444,0
846,D.Vekic,P.Cetkovska,846,1,1,69,28,31,7,53,23,47,11,0.3541666666666667,0.1346153846153846,0.43010752688172044,16,5,-4,1.3018867924528301,3.225806451612903,35,100,0.5652985074626866,16.0,-4.0,57.115671641791046,1,69,1,31.0,1.0,31.0,1.3018867924528301,1
847,A.Petkovic,P.Parmentier,847,1,0,62,16,38,10,77,28,23,7,0.5,0.19230769230769232,0.17204301075268819,-15,-12,3,0.8051948051948052,2.6315789473684212,26,100,0.5652985074626866,-15.0,3.0,57.115671641791046,1,62,1,38.0,0.0,38.0,0.8051948051948052,0
848,J.Hampton,S.Stephens,848,1,1,73,34,27,6,66,21,34,11,0.2708333333333333,0.11538461538461539,0.2903225806451613,7,13,-5,1.106060606060606,3.7037037037037037,40,100,0.5652985074626866,7.0,-5.0,57.115671641791046,1,73,1,27.0,1.0,27.0,1.106060606060606,1
849,V.Lepchenko,E.Birnerova,849,1,1,76,44,24,15,72,43,28,13,0.20833333333333334,0.28846153846153844,0.22580645161290322,4,1,2,1.0555555555555556,4.166666666666667,59,100,0.5652985074626866,4.0,2.0,57.115671641791046,1,76,1,24.0,1.0,24.0,1.0555555555555556,1
850,L.Tsurenko,L.Arruabarrena,850,1,0,79,23,21,4,60,24,40,10,0.14583333333333334,0.07692307692307693,0.3548387096774194,19,-1,-6,1.3166666666666667,4.761904761904762,27,100,0.5652985074626866,19.0,-6.0,57.115671641791046,1,79,1,21.0,0.0,21.0,1.3166666666666667,0
851,M.Doi,S.Soler-Espinosa,851,1,1,58,33,42,10,64,25,36,14,0.5833333333333334,0.19230769230769232,0.3118279569892473,-6,8,-4,0.90625,2.380952380952381,43,100,0.5652985074626866,-6.0,-4.0,57.115671641791046,1,58,1,42.0,1.0,42.0,0.90625,1
852,M.Puig,S.Errani,852,1,0,75,28,25,6,68,28,32,13,0.22916666666666666,0.11538461538461539,0.26881720430107525,7,0,-7,1.1029411764705883,4.0,34,100,0.5652985074626866,7.0,-7.0,57.115671641791046,1,75,1,25.0,0.0,25.0,1.1029411764705883,0
853,N.Li,M.Krajicek,853,1,0,50,11,50,11,62,24,38,11,0.75,0.21153846153846154,0.3333333333333333,-12,-13,0,0.8064516129032258,2.0,22,100,0.5652985074626866,-12.0,0.0,57.115671641791046,1,50,1,50.0,0.0,50.0,0.8064516129032258,0
854,S.Halep,O.Govortsova,854,1,0,58,30,42,16,56,29,44,15,0.5833333333333334,0.3076923076923077,0.3978494623655914,2,1,1,1.0357142857142858,2.380952380952381,46,100,0.5652985074626866,2.0,1.0,57.115671641791046,1,58,1,42.0,0.0,42.0,1.0357142857142858,1
855,A.Beck,N.Bratchikova,855,1,0,65,20,35,8,72,29,28,14,0.4375,0.15384615384615385,0.22580645161290322,-7,-9,-6,0.9027777777777778,2.857142857142857,28,100,0.5652985074626866,-7.0,-6.0,57.115671641791046,1,65,1,35.0,0.0,35.0,0.9027777777777778,0
856,D.Hantuchova,K.Zakopalova,856,1,1,54,28,46,13,63,15,37,8,0.6666666666666666,0.25,0.3225806451612903,-9,13,5,0.8571428571428571,2.1739130434782608,41,100,0.5652985074626866,-9.0,5.0,57.115671641791046,1,54,1,46.0,1.0,46.0,0.8571428571428571,1
857,D.Cibulkova,M.Camerin,857,1,0,55,42,45,26,65,43,35,17,0.6458333333333334,0.5,0.3010752688172043,-10,-1,9,0.8461538461538461,2.2222222222222223,68,100,0.5652985074626866,-10.0,9.0,57.115671641791046,1,55,1,45.0,0.0,45.0,0.8461538461538461,0
858,I.Begu,M.Torro-Flor,858,1,1,72,25,28,8,61,23,39,11,0.2916666666666667,0.15384615384615385,0.34408602150537637,11,2,-3,1.180327868852459,3.5714285714285716,33,100,0.5652985074626866,11.0,-3.0,57.115671641791046,1,72,1,28.0,1.0,28.0,1.180327868852459,1
859,J.Cepelova,Kr.Pliskova,859,1,0,69,16,31,6,62,24,38,12,0.3541666666666667,0.11538461538461539,0.3333333333333333,7,-8,-6,1.1129032258064515,3.225806451612903,22,100,0.5652985074626866,7.0,-6.0,57.115671641791046,1,69,1,31.0,0.0,31.0,1.1129032258064515,0
860,C.Scheepers,R.Vinci,860,1,1,57,24,43,14,52,10,48,7,0.6041666666666666,0.2692307692307692,0.44086021505376344,5,14,7,1.0961538461538463,2.3255813953488373,38,100,0.5652985074626866,5.0,7.0,57.115671641791046,1,57,1,43.0,1.0,43.0,1.0961538461538463,1
861,N.Petrova,Ka.Pliskova,861,1,1,73,33,27,4,60,20,40,8,0.2708333333333333,0.07692307692307693,0.3548387096774194,13,13,-4,1.2166666666666666,3.7037037037037037,37,100,0.5652985074626866,13.0,-4.0,57.115671641791046,1,73,1,27.0,1.0,27.0,1.2166666666666666,1
862,P.Martic,A.Tatishvili,862,1,0,67,31,33,13,59,32,41,14,0.3958333333333333,0.25,0.3655913978494624,8,-1,-1,1.1355932203389831,3.0303030303030303,44,100,0.5652985074626866,8.0,-1.0,57.115671641791046,1,67,1,33.0,0.0,33.0,1.1355932203389831,0
863,M.Rybarikova,B.Zahlavova Strycova,863,1,1,62,37,38,14,64,29,36,16,0.5,0.2692307692307692,0.3118279569892473,-2,8,-2,0.96875,2.6315789473684212,51,100,0.5652985074626866,-2.0,-2.0,57.115671641791046,1,62,1,38.0,1.0,38.0,0.96875,1
864,T.Pironkova,A.Pavlyuchenkova,864,1,0,57,9,43,5,60,18,40,13,0.6041666666666666,0.09615384615384616,0.3548387096774194,-3,-9,-8,0.95,2.3255813953488373,14,100,0.5652985074626866,-3.0,-8.0,57.115671641791046,1,57,1,43.0,0.0,43.0,0.95,0
865,M.Barthel,M.Niculescu,865,1,0,85,46,15,7,68,39,32,17,0.020833333333333332,0.1346153846153846,0.26881720430107525,17,7,-10,1.25,6.666666666666667,53,100,0.5652985074626866,17.0,-10.0,57.115671641791046,1,85,1,15.0,0.0,15.0,1.25,1
866,M.Keys,H.Watson,866,1,0,53,18,47,13,63,25,37,10,0.6875,0.25,0.3225806451612903,-10,-7,3,0.8412698412698413,2.127659574468085,31,100,0.5652985074626866,-10.0,3.0,57.115671641791046,1,53,1,47.0,0.0,47.0,0.8412698412698413,0
867,M.Johansson,T.Babos,867,1,0,51,25,49,15,59,32,41,17,0.7291666666666666,0.28846153846153844,0.3655913978494624,-8,-7,-2,0.864406779661017,2.0408163265306123,40,100,0.5652985074626866,-8.0,-2.0,57.115671641791046,1,51,1,49.0,0.0,49.0,0.864406779661017,0
868,Y.Meusburger,A.Radwanska,868,1,1,73,24,27,5,64,7,36,6,0.2708333333333333,0.09615384615384616,0.3118279569892473,9,17,-1,1.140625,3.7037037037037037,29,100,0.5652985074626866,9.0,-1.0,57.115671641791046,1,73,1,27.5,1.0,27.0,1.140625,1
869,A.Kerber,B.Mattek-Sands,869,1,0,55,29,45,10,58,21,42,13,0.6458333333333334,0.19230769230769232,0.3763440860215054,-3,8,-3,0.9482758620689655,2.2222222222222223,39,100,0.5652985074626866,-3.0,-3.0,57.115671641791046,1,55,1,45.0,0.0,45.0,0.9482758620689655,1
870,T.Moore,K.Kanepi,870,1,1,54,48,46,26,58,58,42,24,0.6666666666666666,0.5,0.3763440860215054,-4,-10,2,0.9310344827586207,2.1739130434782608,74,100,0.5652985074626866,-4.0,2.0,57.115671641791046,1,54,1,46.0,1.0,46.0,0.9310344827586207,0
871,U.Radwanska,M.Burdette,871,1,0,74,38,26,10,68,39,32,15,0.25,0.19230769230769232,0.26881720430107525,6,-1,-5,1.088235294117647,3.8461538461538463,48,100,0.5652985074626866,6.0,-5.0,57.115671641791046,1,74,1,26.0,0.0,26.0,1.088235294117647,0
872,A.Riske,R.Oprandi,872,1,0,68,34,32,12,72,50,28,10,0.375,0.23076923076923078,0.22580645161290322,-4,-16,2,0.9444444444444444,3.125,46,100,0.5652985074626866,-4.0,2.0,57.115671641791046,1,68,1,32.0,0.0,32.0,0.9444444444444444,0
873,S.Peng,A.Medina Garrigues,873,1,0,66,19,34,9,70,44,30,9,0.4166666666666667,0.17307692307692307,0.24731182795698925,-4,-25,0,0.9428571428571428,2.9411764705882355,28,100,0.5652985074626866,-4.0,0.0,57.115671641791046,1,66,1,34.0,0.0,34.0,0.9428571428571428,0
874,M.Erakovic,A.Morita,874,1,0,75,41,25,8,59,45,41,15,0.22916666666666666,0.15384615384615385,0.3655913978494624,16,-4,-7,1.271186440677966,4.0,49,100,0.5652985074626866,16.0,-7.0,57.115671641791046,1,75,1,25.0,0.0,25.0,1.271186440677966,0
875,J.Goerges,M.Duque-Marino,875,1,1,64,48,36,20,62,47,38,21,0.4583333333333333,0.38461538461538464,0.3333333333333333,2,1,-1,1.032258064516129,2.7777777777777777,68,100,0.5652985074626866,2.0,-1.0,57.115671641791046,1,64,1,36.0,1.0,36.0,1.032258064516129,1
876,L.Robson,M.Kirilenko,876,1,0,60,21,40,10,53,24,47,16,0.5416666666666666,0.19230769230769232,0.43010752688172044,7,-3,-6,1.1320754716981132,2.5,31,100,0.5652985074626866,7.0,-6.0,57.115671641791046,1,60,1,40.0,0.0,40.0,1.1320754716981132,0
877,S.Stosur,A.Schmiedlova,877,1,0,65,24,35,7,65,25,35,8,0.4375,0.1346153846153846,0.3010752688172043,0,-1,-1,1.0,2.857142857142857,31,100,0.5652985074626866,0.0,-1.0,57.115671641791046,1,65,1,35.0,0.0,35.0,1.0,0
878,A.Rus,O.Puchkova,878,1,1,69,24,31,4,56,19,44,15,0.3541666666666667,0.07692307692307693,0.3978494623655914,13,5,-11,1.2321428571428572,3.225806451612903,28,100,0.5652985074626866,13.0,-11.0,57.115671641791046,1,69,1,31.0,1.0,31.0,1.2321428571428572,1
879,A.Hlavackova,E.Vesnina,879,1,1,73,29,27,7,79,25,21,6,0.2708333333333333,0.1346153846153846,0.15053763440860216,-6,4,1,0.9240506329113924,3.7037037037037037,36,100,0.5652985074626866,-6.0,1.0,57.115671641791046,1,73,1,27.0,1.0,27.0,0.9240506329113924,1
880,F.Schiavone,S.Lisicki,880,1,1,60,27,40,11,54,15,46,11,0.5416666666666666,0.21153846153846154,0.41935483870967744,6,12,0,1.1111111111111112,2.5,38,100,0.5652985074626866,6.0,0.0,57.115671641791046,1,60,1,40.0,1.0,40.0,1.1111111111111112,1
881,T.Paszek,A.Cadantu,881,1,1,71,29,29,8,66,19,34,6,0.3125,0.15384615384615385,0.2903225806451613,5,10,2,1.0757575757575757,3.4482758620689653,37,100,0.5652985074626866,5.0,2.0,57.115671641791046,1,71,1,29.0,1.0,29.0,1.0757575757575757,1
882,C.Witthoeft,K.Date-Krumm,882,1,1,65,17,35,10,41,6,59,7,0.4375,0.19230769230769232,0.5591397849462365,24,11,3,1.5853658536585367,2.857142857142857,27,100,0.5652985074626866,24.0,3.0,57.115671641791046,1,65,1,35.0,1.0,35.0,1.5853658536585367,1
883,J.Zheng,C.Garcia,883,1,1,64,33,36,11,70,25,30,10,0.4583333333333333,0.21153846153846154,0.24731182795698925,-6,8,1,0.9142857142857143,2.7777777777777777,44,100,0.5652985074626866,-6.0,1.0,57.115671641791046,1,64,1,36.0,1.0,36.0,0.9142857142857143,1
884,M.Minella,S.Williams,884,1,1,73,23,27,7,48,12,52,12,0.2708333333333333,0.1346153846153846,0.4838709677419355,25,11,-5,1.5208333333333333,3.7037037037037037,30,100,0.5652985074626866,25.0,-5.0,57.115671641791046,1,73,1,27.0,1.0,27.0,1.5208333333333333,1
885,S-W.Hsieh,A.Cornet,885,2,1,64,29,36,14,53,14,47,9,0.4583333333333333,0.2692307692307692,0.43010752688172044,11,15,5,1.2075471698113207,2.7777777777777777,43,100,-0.4467005076142132,11.0,5.0,54.19796954314721,2,64,1,36.0,1.0,36.0,1.2075471698113207,1
886,K.Flipkens,B.Jovanovski,886,2,0,59,24,41,15,58,27,42,14,0.5625,0.28846153846153844,0.3763440860215054,1,-3,1,1.0172413793103448,2.4390243902439024,39,100,-0.4467005076142132,1.0,1.0,54.19796954314721,2,59,1,41.0,0.0,41.0,1.0172413793103448,0
887,V.Dolonc,J.Jankovic,887,2,0,61,23,39,7,72,33,28,11,0.5208333333333334,0.1346153846153846,0.22580645161290322,-11,-10,-4,0.8472222222222222,2.5641025641025643,30,100,-0.4467005076142132,-11.0,-4.0,54.19796954314721,2,61,1,39.0,0.0,39.0,0.8472222222222222,0
888,A.Ivanovic,E.Bouchard,888,2,1,54,25,46,10,51,12,49,10,0.6666666666666666,0.19230769230769232,0.45161290322580644,3,13,0,1.0588235294117647,2.1739130434782608,35,100,-0.4467005076142132,3.0,0.0,54.19796954314721,2,54,1,46.0,1.0,46.0,1.0588235294117647,1
889,M.Lucic-Baroni,C.Suarez Navarro,889,2,1,59,30,41,16,56,28,44,16,0.5625,0.3076923076923077,0.3978494623655914,3,2,0,1.0535714285714286,2.4390243902439024,46,100,-0.4467005076142132,3.0,0.0,54.19796954314721,2,59,1,41.0,1.0,41.0,1.0535714285714286,1
890,E.Makarova,G.Muguruza,890,2,0,58,37,42,21,68,49,32,16,0.5833333333333334,0.40384615384615385,0.26881720430107525,-10,-12,5,0.8529411764705882,2.380952380952381,58,100,-0.4467005076142132,-10.0,5.0,54.19796954314721,2,58,1,42.0,0.0,42.0,0.8529411764705882,0
891,M.Sharapova,M.Larcher De Brito,891,2,1,71,34,29,16,60,20,40,9,0.3125,0.3076923076923077,0.3548387096774194,11,14,7,1.1833333333333333,3.4482758620689653,50,100,-0.4467005076142132,11.0,7.0,54.19796954314721,2,71,1,29.0,1.0,29.0,1.1833333333333333,1
892,K.Knapp,L.Safarova,892,2,0,65,37,35,19,67,39,33,14,0.4375,0.36538461538461536,0.27956989247311825,-2,-2,5,0.9701492537313433,2.857142857142857,56,100,-0.4467005076142132,-2.0,5.0,54.19796954314721,2,65,1,35.0,0.0,35.0,0.9701492537313433,0
893,S.Cirstea,C.Giorgi,893,2,1,53,36,47,20,58,40,42,16,0.6875,0.38461538461538464,0.3763440860215054,-5,-4,4,0.9137931034482759,2.127659574468085,56,100,-0.4467005076142132,-5.0,4.0,54.19796954314721,2,53,1,47.0,1.0,47.0,0.9137931034482759,0
894,C.McHale,M.Bartoli,894,2,1,64,38,36,11,64,26,36,11,0.4583333333333333,0.21153846153846154,0.3118279569892473,0,12,0,1.0,2.7777777777777777,49,100,-0.4467005076142132,0.0,0.0,54.19796954314721,2,64,1,36.0,1.0,36.0,1.0,1
895,C.Wozniacki,P.Cetkovska,895,2,1,71,31,29,7,69,15,31,8,0.3125,0.1346153846153846,0.25806451612903225,2,16,-1,1.0289855072463767,3.4482758620689653,38,100,-0.4467005076142132,2.0,-1.0,54.19796954314721,2,71,1,29.0,1.0,29.0,1.0289855072463767,1
896,A.Petkovic,S.Stephens,896,2,1,64,48,36,19,63,38,37,22,0.4583333333333333,0.36538461538461536,0.3225806451612903,1,10,-3,1.0158730158730158,2.7777777777777777,67,100,-0.4467005076142132,1.0,-3.0,54.19796954314721,2,64,1,36.0,1.0,36.0,1.0158730158730158,1
897,E.Birnerova,L.Tsurenko,897,2,0,48,17,52,17,55,23,45,19,0.7916666666666666,0.3269230769230769,0.40860215053763443,-7,-6,-2,0.8727272727272727,1.9230769230769231,34,100,-0.4467005076142132,-7.0,-2.0,54.19796954314721,2,48,1,52.0,0.0,52.0,0.8727272727272727,0
898,S.Soler-Espinosa,M.Puig,898,2,1,63,43,37,24,57,38,43,18,0.4791666666666667,0.46153846153846156,0.3870967741935484,6,5,6,1.105263157894737,2.7027027027027026,67,100,-0.4467005076142132,6.0,6.0,54.19796954314721,2,63,1,37.0,1.0,37.0,1.105263157894737,1
899,N.Li,S.Halep,899,2,0,71,28,29,8,73,29,27,7,0.3125,0.15384615384615385,0.21505376344086022,-2,-1,1,0.9726027397260274,3.4482758620689653,36,100,-0.4467005076142132,-2.0,1.0,54.19796954314721,2,71,1,29.0,0.0,29.0,0.9726027397260274,0
900,A.Beck,K.Zakopalova,900,2,1,59,28,41,10,66,23,34,9,0.5625,0.19230769230769232,0.2903225806451613,-7,5,1,0.8939393939393939,2.4390243902439024,38,100,-0.4467005076142132,-7.0,1.0,54.19796954314721,2,59,1,41.0,1.0,41.0,0.8939393939393939,1
901,D.Cibulkova,M.Torro-Flor,901,2,0,61,9,39,6,44,15,56,13,0.5208333333333334,0.11538461538461539,0.5268817204301075,17,-6,-7,1.3863636363636365,2.5641025641025643,15,100,-0.4467005076142132,17.0,-7.0,54.19796954314721,2,61,1,39.0,0.0,39.0,1.3863636363636365,0
902,J.Cepelova,R.Vinci,902,2,1,58,47,42,15,61,37,39,22,0.5833333333333334,0.28846153846153844,0.34408602150537637,-3,10,-7,0.9508196721311475,2.380952380952381,62,100,-0.4467005076142132,-3.0,-7.0,54.19796954314721,2,58,1,42.0,1.0,42.0,0.9508196721311475,1
903,Ka.Pliskova,P.Martic,903,2,1,54,24,46,15,63,28,37,6,0.6666666666666666,0.28846153846153844,0.3225806451612903,-9,-4,9,0.8571428571428571,2.1739130434782608,39,100,-0.4467005076142132,-9.0,9.0,54.19796954314721,2,54,1,46.0,1.0,46.0,0.8571428571428571,0
904,B.Zahlavova Strycova,T.Pironkova,904,2,1,68,37,32,10,64,28,36,15,0.375,0.19230769230769232,0.3118279569892473,4,9,-5,1.0625,3.125,47,100,-0.4467005076142132,4.0,-5.0,54.19796954314721,2,68,1,32.0,1.0,32.0,1.0625,1
905,M.Barthel,M.Keys,905,2,1,65,25,35,12,74,32,26,8,0.4375,0.23076923076923078,0.20430107526881722,-9,-7,4,0.8783783783783784,2.857142857142857,37,100,-0.4467005076142132,-9.0,4.0,54.19796954314721,2,65,1,35.0,1.0,35.0,0.8783783783783784,0
906,M.Johansson,A.Radwanska,906,2,1,62,23,38,12,66,24,34,6,0.5,0.23076923076923078,0.2903225806451613,-4,-1,6,0.9393939393939394,2.6315789473684212,35,100,-0.4467005076142132,-4.0,6.0,54.19796954314721,2,62,1,38.0,1.0,38.0,0.9393939393939394,0
907,S.Peng,M.Erakovic,907,2,1,58,35,42,15,74,30,26,9,0.5833333333333334,0.28846153846153844,0.20430107526881722,-16,5,6,0.7837837837837838,2.380952380952381,50,100,-0.4467005076142132,-16.0,6.0,54.19796954314721,2,58,1,42.0,1.0,42.0,0.7837837837837838,1
908,S.Stosur,O.Puchkova,908,2,0,56,9,44,3,69,20,31,11,0.625,0.057692307692307696,0.25806451612903225,-13,-11,-8,0.8115942028985508,2.272727272727273,12,100,-0.4467005076142132,-13.0,-8.0,54.19796954314721,2,56,1,44.0,0.0,44.0,0.8115942028985508,0
909,E.Vesnina,S.Lisicki,909,2,1,65,28,35,10,74,14,26,4,0.4375,0.19230769230769232,0.20430107526881722,-9,14,6,0.8783783783783784,2.857142857142857,38,100,-0.4467005076142132,-9.0,6.0,54.19796954314721,2,65,1,35.0,1.0,35.0,0.8783783783783784,1
910,A.Cadantu,K.Date-Krumm,910,2,1,79,32,21,8,79,30,21,7,0.14583333333333334,0.15384615384615385,0.15053763440860216,0,2,1,1.0,4.761904761904762,40,100,-0.4467005076142132,0.0,1.0,54.19796954314721,2,79,1,21.0,1.0,21.0,1.0,1
911,C.Garcia,S.Williams,911,2,1,71,25,29,8,75,24,25,9,0.3125,0.15384615384615385,0.1935483870967742,-4,1,-1,0.9466666666666667,3.4482758620689653,33,100,-0.4467005076142132,-4.0,-1.0,54.19796954314721,2,71,1,29.0,1.0,29.0,0.9466666666666667,1
912,F.Pennetta,A.Cornet,912,3,0,56,28,44,19,56,30,44,16,0.625,0.36538461538461536,0.3978494623655914,0,-2,3,1.0,2.272727272727273,47,100,0.037383177570093455,0.0,3.0,50.467289719626166,3,56,1,44.0,0.0,44.0,1.0,0
913,K.Flipkens,V.Dolonc,913,3,0,65,11,35,8,63,27,37,8,0.4375,0.15384615384615385,0.3225806451612903,2,-16,0,1.0317460317460319,2.857142857142857,19,100,0.037383177570093455,2.0,0.0,50.467289719626166,3,65,1,35.0,0.0,35.0,1.0317460317460319,0
914,E.Bouchard,C.Suarez Navarro,914,3,1,66,31,34,13,56,25,44,15,0.4166666666666667,0.25,0.3978494623655914,10,6,-2,1.1785714285714286,2.9411764705882355,44,100,0.037383177570093455,10.0,-2.0,50.467289719626166,3,66,1,34.0,1.0,34.0,1.1785714285714286,1
915,E.Makarova,P.Kvitova,915,3,0,63,30,37,8,75,35,25,8,0.4791666666666667,0.15384615384615385,0.1935483870967742,-12,-5,0,0.84,2.7027027027027026,38,100,0.037383177570093455,-12.0,0.0,50.467289719626166,3,63,1,37.0,0.0,37.0,0.84,0
916,M.Larcher De Brito,K.Knapp,916,3,1,57,32,43,13,71,28,29,9,0.6041666666666666,0.25,0.23655913978494625,-14,4,4,0.8028169014084507,2.3255813953488373,45,100,0.037383177570093455,-14.0,4.0,50.467289719626166,3,57,1,43.0,1.0,43.0,0.8028169014084507,1
917,C.Giorgi,M.Bartoli,917,3,1,62,26,38,10,60,21,40,14,0.5,0.19230769230769232,0.3548387096774194,2,5,-4,1.0333333333333334,2.6315789473684212,36,100,0.037383177570093455,2.0,-4.0,50.467289719626166,3,62,1,38.0,1.0,38.0,1.0333333333333334,1
918,P.Cetkovska,S.Stephens,918,3,0,79,32,21,3,56,23,44,17,0.14583333333333334,0.057692307692307696,0.3978494623655914,23,9,-14,1.4107142857142858,4.761904761904762,35,100,0.037383177570093455,23.0,-14.0,50.467289719626166,3,79,1,21.0,0.0,21.0,1.4107142857142858,1
919,E.Birnerova,M.Puig,919,3,0,58,15,42,8,75,22,25,5,0.5833333333333334,0.15384615384615385,0.1935483870967742,-17,-7,3,0.7733333333333333,2.380952380952381,23,100,0.037383177570093455,-17.0,3.0,50.467289719626166,3,58,1,42.0,0.0,42.0,0.7733333333333333,0
920,N.Li,K.Zakopalova,920,3,0,62,35,38,14,69,43,31,15,0.5,0.2692307692307692,0.25806451612903225,-7,-8,-1,0.8985507246376812,2.6315789473684212,49,100,0.037383177570093455,-7.0,-1.0,50.467289719626166,3,62,1,38.0,0.0,38.0,0.8985507246376812,0
921,D.Cibulkova,R.Vinci,921,3,1,56,18,44,17,64,15,36,9,0.625,0.3269230769230769,0.3118279569892473,-8,3,8,0.875,2.272727272727273,35,100,0.037383177570093455,-8.0,8.0,50.467289719626166,3,56,1,44.0,1.0,44.0,0.875,1
922,P.Martic,T.Pironkova,922,3,1,57,34,43,21,50,20,50,14,0.6041666666666666,0.40384615384615385,0.46236559139784944,7,14,7,1.14,2.3255813953488373,55,100,0.037383177570093455,7.0,7.0,50.467289719626166,3,57,1,43.0,1.0,43.0,1.14,1
923,M.Keys,A.Radwanska,923,3,1,71,55,29,18,61,53,39,16,0.3125,0.34615384615384615,0.34408602150537637,10,2,2,1.1639344262295082,3.4482758620689653,73,100,0.037383177570093455,10.0,2.0,50.467289719626166,3,71,1,27.0,1.0,29.0,1.1639344262295082,1
924,K.Kanepi,A.Riske,924,3,0,60,15,40,8,53,22,47,13,0.5416666666666666,0.15384615384615385,0.43010752688172044,7,-7,-5,1.1320754716981132,2.5,23,100,0.037383177570093455,7.0,-5.0,50.467289719626166,3,60,1,40.0,0.0,40.0,1.1320754716981132,0
925,M.Erakovic,L.Robson,925,3,1,59,35,41,16,60,37,40,13,0.5625,0.3076923076923077,0.3548387096774194,-1,-2,3,0.9833333333333333,2.4390243902439024,51,100,0.037383177570093455,-1.0,3.0,50.467289719626166,3,59,1,41.0,1.0,41.0,0.9833333333333333,0
926,S.Stosur,S.Lisicki,926,3,1,68,39,32,13,61,32,39,15,0.375,0.25,0.34408602150537637,7,7,-2,1.1147540983606556,3.125,52,100,0.037383177570093455,7.0,-2.0,50.467289719626166,3,68,1,32.0,1.0,32.0,1.1147540983606556,1
927,K.Date-Krumm,S.Williams,927,3,1,64,21,36,8,64,10,36,9,0.4583333333333333,0.15384615384615385,0.3118279569892473,0,11,-1,1.0,2.7777777777777777,29,100,0.037383177570093455,0.0,-1.0,50.467289719626166,3,64,1,36.0,1.0,36.0,1.0,1
928,F.Pennetta,K.Flipkens,928,4,1,60,26,40,14,66,26,34,11,0.5416666666666666,0.2692307692307692,0.2903225806451613,-6,0,3,0.9090909090909091,2.5,40,100,0.38181818181818183,-6.0,3.0,55.54545454545455,4,60,1,40.0,1.0,40.0,0.9090909090909091,0
929,C.Suarez Navarro,P.Kvitova,929,4,1,70,40,30,10,66,31,34,11,0.3333333333333333,0.19230769230769232,0.2903225806451613,4,9,-1,1.0606060606060606,3.3333333333333335,50,100,0.38181818181818183,4.0,-1.0,55.54545454545455,4,70,1,30.0,1.0,30.0,1.0606060606060606,1
930,K.Knapp,M.Bartoli,930,4,1,61,26,39,7,60,18,40,4,0.5208333333333334,0.1346153846153846,0.3548387096774194,1,8,3,1.0166666666666666,2.5641025641025643,33,100,0.38181818181818183,1.0,3.0,55.54545454545455,4,61,1,39.0,1.0,39.0,1.0166666666666666,1
931,S.Stephens,M.Puig,931,4,0,61,30,39,20,63,46,37,13,0.5208333333333334,0.38461538461538464,0.3225806451612903,-2,-16,7,0.9682539682539683,2.5641025641025643,50,100,0.38181818181818183,-2.0,7.0,55.54545454545455,4,61,1,39.0,0.0,39.0,0.9682539682539683,0
932,N.Li,R.Vinci,932,4,0,64,12,36,5,61,21,39,10,0.4583333333333333,0.09615384615384616,0.34408602150537637,3,-9,-5,1.0491803278688525,2.7777777777777777,17,100,0.38181818181818183,3.0,-5.0,55.54545454545455,4,64,1,36.0,0.0,36.0,1.0491803278688525,0
933,T.Pironkova,A.Radwanska,933,4,1,71,47,29,17,55,37,45,18,0.3125,0.3269230769230769,0.40860215053763443,16,10,-1,1.290909090909091,3.4482758620689653,64,100,0.38181818181818183,16.0,-1.0,55.54545454545455,4,71,1,29.0,1.0,29.0,1.290909090909091,1
934,K.Kanepi,L.Robson,934,4,0,57,32,43,16,60,44,40,14,0.6041666666666666,0.3076923076923077,0.3548387096774194,-3,-12,2,0.95,2.3255813953488373,48,100,0.38181818181818183,-3.0,2.0,55.54545454545455,4,57,1,43.0,0.0,43.0,0.95,0
935,S.Lisicki,S.Williams,935,4,0,62,31,38,16,61,38,39,20,0.5,0.3076923076923077,0.34408602150537637,1,-7,-4,1.0163934426229508,2.6315789473684212,47,100,0.38181818181818183,1.0,-4.0,55.54545454545455,4,62,1,38.0,0.0,38.0,1.0163934426229508,0
936,K.Flipkens,P.Kvitova,936,5,0,72,50,28,11,62,42,38,17,0.2916666666666667,0.21153846153846154,0.3333333333333333,10,8,-6,1.1612903225806452,3.5714285714285716,61,100,-1.2222222222222223,10.0,-6.0,54.333333333333336,5,72,1,28.0,0.0,28.0,1.1612903225806452,1
937,M.Bartoli,S.Stephens,937,5,0,63,24,37,5,58,26,42,15,0.4791666666666667,0.09615384615384616,0.3763440860215054,5,-2,-10,1.0862068965517242,2.7027027027027026,29,100,-1.2222222222222223,5.0,-10.0,54.333333333333336,5,63,1,37.0,0.0,37.0,1.0862068965517242,0
938,N.Li,A.Radwanska,938,5,1,77,52,23,9,77,57,23,13,0.1875,0.17307692307692307,0.17204301075268819,0,-5,-4,1.0,4.3478260869565215,61,100,-1.2222222222222223,0.0,-4.0,54.333333333333336,5,77,1,23.0,1.0,23.0,1.0,0
939,K.Kanepi,S.Lisicki,939,5,1,59,26,41,10,67,25,33,9,0.5625,0.19230769230769232,0.27956989247311825,-8,1,1,0.8805970149253731,2.4390243902439024,36,100,-1.2222222222222223,-8.0,1.0,54.333333333333336,5,59,1,41.0,1.0,41.0,0.8805970149253731,1
940,K.Flipkens,M.Bartoli,940,6,1,61,21,39,10,49,8,51,7,0.5208333333333334,0.19230769230769232,0.4731182795698925,12,13,3,1.2448979591836735,2.5641025641025643,31,100,-3.2857142857142856,12.0,3.0,57.357142857142854,6,61,1,39.0,1.0,39.0,1.2448979591836735,1
941,A.Radwanska,S.Lisicki,941,6,1,63,53,37,19,70,42,30,15,0.4791666666666667,0.36538461538461536,0.24731182795698925,-7,11,4,0.9,2.7027027027027026,72,100,-3.2857142857142856,-7.0,4.0,57.357142857142854,6,63,1,37.0,1.0,37.0,0.9,1
942,M.Bartoli,S.Lisicki,942,7,0,65,22,35,9,67,31,33,7,0.4375,0.17307692307692307,0.27956989247311825,-2,-9,2,0.9701492537313433,2.857142857142857,31,100,5.285714285714286,-2.0,2.0,47.857142857142854,7,65,1,35.0,0.0,35.0,0.9701492537313433,0
